abandon	ə'bændən	vt.丢弃；放弃，抛弃
aboard	ə'bɔ:d	ad.在船(车)上；上船
absolute	æbsəlu:t	a.绝对的；纯粹的
absolutely	æbsəlu:tli	ad.完全地；绝对地
absorb	əb'sɔ:b	vt.吸收；使专心
abstract	æbstrækt	n.摘要
abundant	ə'bΛndənt	a.丰富的；大量的
abuse	ə'bju:z,ə'bju:s	vt.滥用；虐待n.滥用
academic	ækə'demik	a.学院的；学术的
accelerate	æk'seləreit	vt.(使)加快；促进
access	ækses	n.接近；通道，入口
accidental	æksi'dentl	a.偶然的；非本质的
accommodate	ə'kɔmədeit	vt.容纳；供应，供给
accommodation	ə,kɔmə'deiʃən	n.招待设备；预定铺位
accompany	ə'kΛmpəni	vt.陪伴，陪同；伴随
accomplish	ə'kɔmpliʃ	vt.达到(目的)；完成
accordance	ə'kɔr:dəns	n.一致；和谐；授予
accordingly	ə'kɔr:diŋli	ad.因此，所以；照着
account	ə'kaunt	n.记述；解释；帐目
accumulate	ə'kju:mjuleit	vt.积累vi.堆积
accuracy	ækjurəsi	n.准确(性)；准确度
accurate	ækjurit	a.准确的，正确无误的
accustomed	ə'kΛstəmd	a.惯常的；习惯的
acid	æsid	n.酸；酸的，酸性的
acquaintance	ə'kweintəns	n.认识；了解；熟人
acquire	ə'kwaiə	vt.取得；获得；学到
acre	eikə	n.英亩(=6.07亩)
adapt	ə'dæpt	vt.使适应；改编
addition	ə'diʃən	n.加，加法；附加物
additional	ə'diʃənl	a.附加的，追加的
address	ə'dres	n.地址；演说；谈吐
adequate	ædikwit	a.足够的；可以胜任的
adjust	ə'dʒΛst	vt.调整，调节；校正
administration	ədminis'treiʃən	n.管理；管理部门
admission	əd'miʃən	n.允许进入；承认
admit	əd'mit	vt.承认；准许…进入
advance	əd'va:ns	vi.前进；提高n.进展
advanced	əd'va:nst	a.先进的；高级的
adventure	əd'ventʃə	n.冒险；惊险活动
advisable	əd'vaizəbl	n.明智的；可取的
affair	ə'feə	n.事情，事件；事务
affect	ə'fekt	vt.影响；感动
affection	ə'fekʃən	n.慈爱，爱；爱慕
afford	ə'fɔr:d	vt.担负得起…；提供
afterward	a:ftəwəd(z)	ad.后来，以后
age	eidʒ	vt.变老
aggressive	ə'gresiv	a.侵略的；好斗的
aircraft	eəkra:ft	n.飞机，飞行器
alarm	ə'la:m	n.惊恐，忧虑；警报
alcohol	ælkəhɔl	n.酒精，乙醇
alike	ə'laik	a.同样的，相同的
alloy	ælɔi,ə'lɔi	n.合金；(金属的)成色
alphabet	ælfəbit	n.字母表，字母系统
alter	ɔ:ltə	vt.改变，变更；改做
alternative	ɔ:l'tə:nətiv	n.替换物；取舍，抉择
altitude	æltitju:d	n.高，高度；高处
aluminium	ælju'minjəm	n.铝
amaze	ə'meiz	vt.使惊奇，使惊愕
ambulance	æmbjuləns	n.救护车；野战医院
amongst	ə'mΛŋst	prep在…之中(=among)
amuse	ə'mju:z	vt.逗…乐；给…娱乐
analyse	ænəlaiz	vt.分析，分解，解析
analysis	ə'næləsis	n.分析，分解，解析
ancestor	ænsistə	n.祖宗，祖先
anchor	æŋkə	n.锚vi.抛锚，停泊
ancient	einʃənt	a.古代的，古老的
ankle	æŋkl	n.踝，踝节部
announce	ə'nauns	vt.宣布，宣告，发表
annoy	ə'nɔi	vt.使恼怒；打搅
annual	ænjuəl	a.每年的n.年报
anticipate	æn'tisipeit	vt.预料，预期，期望
anxiety	æŋg'zaiəti	n.焦虑，忧虑；渴望
anxious	æŋkʃəs	a.忧虑的；渴望的
apart	ə'pa:t	ad.相隔；分开；除去
apologize	ə'pɔlədʒaiz	vi.道歉，谢罪，认错
apparatus	,æpə'reitəs	n.器械，仪器；器官
appeal	ə'pi:l	vi.&n.呼吁；申述
appetite	æpitait	n.食欲，胃口；欲望
appliance	ə'plaiəns	n.用具，器具，器械
applicable	æplikəbl	a.能应用的；适当的
application	æpli'keiʃən	n.请求，申请；施用
appɔint	ə'pɔint	vt.任命，委任；约定
appreciate	ə'pri:ʃieit	vt.欣赏；领会；感谢
approval	ə'pru:vəl	n.赞成，同意；批准
approve	ə'pru:v	vt.赞成，称许；批准
approximate	ə'prɔksimit	a.近似的vt.近似
arbitrary	a:bitrəri	a.随心所欲的；专断的
architecture	a:kitektʃə	n.建筑学；建筑式样
argue	a:gju:	vi.争论，争辩，辩论
argument	a:gju:mənt	n.争论，辩论；理由
arise	ə'raiz	vi.出现；由…引起
arithmetic	ə'riθmətik	n.算术，四则运算
arouse	ə'rauz	vt.引起，唤起；唤醒
article	a:tikl	n.条款；物品
artificial	a:ti'fiʃəl	a.人工的；娇揉造作的
artistic	a:'tistik	a.艺术的；艺术家的
ash	æʃ	n.灰，灰末；骨灰
ashamed	ə'ʃeimd	a.惭愧(的)；羞耻(的)
aspect	æspekt	n.方面；样子，外表
assemble	ə'sembl	vt.集合，召集；装配
assembly	ə'sembli	n.集合；集会；装配
assess	ə'ses	vt.对(财产等)估价
assign	ə'sain	vt.指派；分配；指定
assist	ə'sist	vt.援助，帮助；搀扶
assistance	ə'sistəns	n.协助,援助
associate	ə'səuʃieit	vi.交往n.伙伴，同事
association	əsəusi'eiʃən	n.协会，团体；联合
assume	ə'sju:m	vt.假定；承担；呈现
assure	ə'ʃuə	vt.使确信；向…保证
astonish	əs'tɔniʃ	vt.使惊讶，使吃惊
astronaut	æstʃəunɔ:t	n.宇宙航行员，宇航员
ætlantic	ət'læntik	a.大西洋的n.大西洋
atom	ætəm	n.原子；微粒；微量
atomic	ə'tɔmik	a.原子的；原子能的
attach	ə'tætʃ	vt.缚，系，贴；附加
attain	tein	vt.达到，获得，完成
attempt	ə'tempt	vt.尝试，试图n.企图
attend	ə'tend	vt.出席；照顾，护理
attribute	ætribju:t	vt.把…归因于n.属性
audience	ɔ:djəns	n.听众，观众，读者
authority	ɔ:'θɔriti	n.当局，官方；权力
automatic	ɔ:tə'mætik	a.自动的；机械的
automobile	ɔ:təməbi:l	n.汽车，机动车
auxiliary	ɔ:g'ziljəri	a.辅助的；附属的
available	ə'veiləbl	a.可利用的；通用的
avenue	ævinju:	n.林荫道，道路；大街
await	ə'weit	vt.等候，期待
awake	ə'weik	a.醒着的vt.唤醒
award	ə'wɔ:d	n.奖，奖品；判定
aware	ə'weə	a.知道的，意识到的
awful	ɔ:ful	a.令人不愉快的
awkward	ɔ:kwəd	a.笨拙的；尴尬的
ax	æks	n.斧子
baby	beibi	n.婴儿；孩子气的人
back	bæk	ad.在后；回原处；回
background	bækgraund	n.背景，后景，经历
backward	bækwəd	a.向后的；倒的ad.倒
bacteria	bæk'tiəriə	n.细菌
bad	bæd	a.坏的，恶的；严重的
badly	bædli	ad.坏，差；严重地
bag	bæg	n.袋，包，钱包，背包
baggage	bægidʒ	n.行李
bake	beik	vt.烤，烘，焙；烧硬
balance	bæləns	vt.使平衡；称n.天平
ball	bɔ:l	n.球，球状物；舞会
balloon	bə'lu:n	n.气球，玩具气球
banana	bə'na:nə	n.香蕉；芭蕉属植物
band	bænd	n.乐队；带；波段
bang	bæŋ	n.巨响，枪声；猛击
bank	bæŋk	n.银行；库；岩，堤
bar	ba:	n.酒吧间；条，杆；栅
barber	ba:bə	n.理发师
bare	beə	a.赤裸的；仅仅的
bargain	ba:gin	n.交易vi.议价；成交
barrel	bærəl	n.桶；圆筒；枪管
barrier	bæriə	n.栅栏，屏障；障碍
base	beis	n.基础，底层；基地
basic	beisik	a.基本的，基础的
basically	beisikəli	ad.基本上
basin	beisn	n.盆，洗脸盆；盆地
basis	beisis	n.基础，根据
basket	ba:skit	n.篮，篓，筐
basketball	ba:skitbɔ:l	n.篮球；篮球运动
bath	ba:θ	n.浴，洗澡；浴缸
bathe	beið	vt.给…洗澡；弄湿
bathroom	ba:θrum	n.浴室；盥洗室
battery	bætəri	n.电池；一套，一组
battle	bætl	n.战役；斗争vi.作战
bay	bei	n.湾；山脉中的凹处
be	bi:	aux.v.&vi.是，在，做
beach	bi:tʃ	n.海滩，湖滩，河滩
beam	bi:m	n.梁；横梁；束，柱
bean	bi:n	n.豆，蚕豆
bear	beə	n.熊；粗鲁的人
bear	beə	vt.容忍；负担；生育
beard	biəd	n.胡须，络腮胡子
beast	bi:st	n.兽，野兽；牲畜
beat	bi:t	vt.&vi.打，敲；打败
beautiful	bju:tiful	a.美的，美丽的
beauty	bju:ti	n.美，美丽；美人
because	bi'kɔz	conj.由于，因为
become	bi'kΛm	vi.变成；成为，变得
bed	bed	n.床，床位；圃；河床
bee	bi:	n.蜂，密蜂；忙碌的人
beef	bi:f	n.牛肉；菜牛
beer	biə	n.啤酒
before	bi'fɔ:	prep.在…以前；向…
beg	beg	vt.&vi.乞求；请求
begin	bi'gin	vi.开始vt.开始
beginning	bi'giniŋ	n.开始，开端；起源
behalf	bi'ha:f	n.利益，维护，支持
behave	bi'heiv	vi.表现，举止；运转
behavior	bi'heivjə	n.行为，举止，态度
behind	bi'haind	prep.在…后面
being	bi:iŋ	n.存在；生物；生命
belief	bi'li:f	n.信任，相信；信念
believe	bi'li:v	vt.相信；认为
bell	bel	n.钟，铃，门铃；钟声
belong	bi'lɔŋ	vi.属于，附属
below	bi'ləu	prep.在…下面(以下)
belt	belt	n.带，腰带；皮带；区
bench	bentʃ	n.长凳，条凳；工作台
bend	bend	vt.使弯曲vi.弯曲
beneath	bi'ni:θ	prep.在…下方
beneficial	beni'fiʃəl	a.有利的，有益的
benefit	benifit	n.利益；恩惠；津贴
beside	bi'said	prep.在…旁边
besides	bi'saidz	ad.而且prep.除…之外
best	best	a.最好的；最大的
bet	bet	vt.&vi.&n.打赌
better	betə	a.较好的ad.更好地
between	bi'twi:n	prep.在…中间
beyond	bi'jɔnd	prep.在…的那边
Bible	baibl	n.基督教《圣经》
bicycle	baisikl	n.自行车，脚踏车
big	big	a.大的，巨大的
bike	baik	n.自行车vi.骑自行车
bill	bil	n.账单；招贴；票据
billion	biljən	num.万亿(英)
bind	baind	vt.捆绑；包扎；装钉
biology	bai'ɔlədʒi	n.生物学；生态学
bird	bə:d	n.鸟，禽
birth	bə:θ	n.分娩，出生；出身
birthday	bə:θdi	n.生日，诞生的日期
biscuit	biskit	n.(英)饼干；(美)软饼
bit	bit	n.一点，一些，小片
bite	bait	vt.咬，叮，螫；剌穿
bitter	bitə	a.痛苦的；严寒的
black	blæk	a.黑色的；黑暗的
blackboard	blækbɔ:d	n.黑板
blade	bleid	n.刀刃，刀片；叶片
blame	bleim	vt.责备，把…归咎于
blank	blæŋk	a.空白的n.空白
blanket	blæŋkit	n.毛毯，毯子，羊毛毯
blast	bla:st	n.爆炸，冲击波vt.炸
bleed	bli:d	vi.出血，流血；泌脂
blend	blend	vt.&vi.&n.混和
blind	blaind	a.瞎的；盲目的
block	blɔk	n.街区vt.堵塞，拦阻
blood	blΛd	n.血，血液；血统
bloom	blu:m	n.花；开花，开花期
blow	bləu	vi.吹，吹动；吹响
blue	blu:	a.蓝色的n.蓝色
board	bɔ:d	n.板vt.上(船、车等)
boast	bəust	vi.自夸vt.吹嘘
boat	bəut	n.小船，艇；渔船
body	bɔdi	n.身体；主体；尸体
bɔil	bɔil	vi.沸腾；汽化vt.煮沸
bold	bəuld	a.大胆的；冒失的
bolt	bəult	n.螺栓；插销vt.闩门
bomb	bɔm	n.炸弹vt.轰炸
bond	bɔnd	n.联结，联系；公债
bone	bəun	n.骨，骨骼
book	buk	n.书，书籍vt.预定
boot	bu:t	n.靴子，长统靴
border	bɔ:də	n.边，边缘；边界
bore	bɔ:	vt.使厌烦；钻，挖
born	bɔ:n	a.天生的；出生的
borrow	bɔrəu	vt.借，借用，借人
boss	bɔs	n.老板，上司vt.指挥
both	bəuθ	pron.两者(都)
bother	bɔðə	vt.烦扰，迷惑n.麻烦
bottle	bɔtl	n.瓶，酒瓶；一瓶
bottom	bɔtəm	n.底，底部，根基
bounce	bauns	vi.反跳，弹起；跳起
bound	baund	a.一定的；有义务的
boundary	baundəri	n.分界线，办界
bow	bau	n.弓；蝴蝶结；鞠躬
bowl	bəul	n.碗，钵；碗状物
box	bɔks	n.箱，盒；包箱
box	bɔks	vi.拳击，打拳
boy	bɔi	n.男孩，少年；家伙
brain	brein	n.脑，脑髓；脑力
brake	breik	n.闸，刹车vi.制动
branch	bra:ntʃ	n.树枝；分部；分科
brand	brænd	n.商品；烙印vt.铭刻
brass	bra:s	n.黄铜；黄铜器
brave	breiv	a.勇敢的，华丽的
bread	bred	n.面包；食物，粮食
breadth	bredð	n.宽度，幅度；幅面
break	breik	vt.打破；损坏；破坏
breakfast	brekfəst	n.早饭，早餐
breast	brest	n.乳房；胸脯，胸膛
breath	breθ	n.气息，呼吸；气味
breathe	bri:ð	vi.呼吸vt.呼吸
breed	bri:d	n.品种vt.使繁殖
breeze	bri:z	n.微风，和风
brick	brik	n.砖，砖块；砖状物
bride	braid	n.新娘
bridge	bridʒ	n.桥，桥梁；桥牌
brief	bri:f	a.简短的；短暂的
bright	brait	a.明亮的；聪明的
brilliant	briljənt	a.光辉的；卓越的
bring	briŋ	vt.带来；引出；促使
British	britiʃ	a.不列颠的，英联邦的
broad	brɔ:d	a.宽的，阔的；广泛的
broadcast	brɔ:dka:st	n.广播，播音
brother	brΛðə	n.兄弟；同事，同胞
brow	brau	n.额；眉，眉毛
brown	braun	n.褐色，棕色
brush	brΛʃ	n.刷子，毛刷；画笔
bubble	bΛbl	n.泡vi.冒泡，沸腾
bucket	bΛkit	n.水桶；吊桶；铲斗
build	bild	vt.建筑；建立；创立
building	bildiŋ	n.建筑物，大楼；建筑
bulb	bΛlb	n.电灯泡；球状物
bulk	bΛlk	n.物体，容积，大批
bullet	bulit	n.枪弹，子弹，弹丸
bundle	bΛndl	n.捆，包，束；包袱
burden	bə:dn	n.担子，重担；装载量
bureau	bjuərəu	n.局，司，处；社，所
burn	bə:n	vi.烧，燃烧n.烧伤
burst	bə:st	vt.使爆裂vi.&n.爆炸
bury	beri	vt.埋葬，葬；埋藏
bus	bΛs	n.公共汽车
bush	buʃ	n.灌木，灌木丛，矮树
business	biznis	n.商业，生意；事务
busy	bizi	a.忙的，繁忙的
but	bΛt	conj.但是，可是
butter	bΛtə	n.黄油；奶油
button	bΛtn	n.扣子；按钮vt.扣紧
buy	bai	vt.买，购买vi.买
by	bai	prep.在…旁；被，由
cabbage	kæbidʒ	n.洋白菜，卷心菜
cabin	kæbin	n.小屋；船舱，机舱
cabinet	kæbinit	n.橱，柜；内阁
cable	keibl	n.缆，索；电缆；电报
cafe	kæfei,kə'fei	n.咖啡馆；小餐厅
cage	keidʒ	n.笼；鸟笼，囚笼
cake	keik	n.饼，糕，蛋糕
calculate	kælkjuleit	vt.计算；估计；计划
calculator	kælkjuleitə	n.计算器，计算者
calendar	kælində	n.日历，历书；历法
call	kɔ:l	vt.把…叫做；叫，喊
calm	ka:m	a.静的，平静的
camel	kæməl	n.骆驼
camera	kæmərə	n.照相机，摄影机
camp	kæmp	n.野营，营地，兵营
campaign	kæm'pein	n.战役；运动
campus	kæmpəs	n.校园，学校场地
can	kæn	aux.v.能，会，可能
can	kæn	n.罐头，听头；容器
Canadian	kə'neidjən	a.加拿大的
canal	kə'næl	n.运河；沟渠；管
cancel	kænsəl	vt.取消，撤消；删去
cancer	kænsə	n.癌，癌症，肿瘤
candidate	kændidit	n.候选人；投考者
candle	kændl	n.蜡烛；烛形物；烛光
cap	kæp	n.帽子，便帽；帽状物
capable	keipəbl	a.有能力的，有才能的
capacity	kə'pæsiti	n.容量；能力；能量
capital	kæpitl	n.资本，资金；首都
captain	kæptin	n.陆军上尉；队长
capture	kæptʃə	vt.捕获，俘获；夺得
car	ka:	n.汽车，小汽车，轿车
carbon	ka:bən	n.碳
card	ka:d	n.卡，卡片，名片
care	keə	vi.关心，介意n.小心
career	kə'riə	n.生涯，职业，经历
careful	keəful	a.仔细的；细致的
careless	keəlis	a.粗心的，漫不经心的
cargo	ka:gəu	n.船货，货物
carpenter	ka:pintə	n.木工，木匠
carpet	ka:pit	n.地毯，毡毯，毛毯
carriage	kæridʒ	n.客车厢；四轮马车
carrier	kæriə	n.运输工具；运载工具
carry	kæri	vt.携带；运载；传送
cart	ka:t	n.二轮运货马车
case	keis	n.情况；事实；病例
case	keis	n.箱(子)，盒(子)，套
cash	kæʃ	n.现金，现款
cassette	ka:'set	n.盒式录音带；盒子
cast	ka:st	vt.投，扔，抛；浇铸
castle	ka:sl	n.城堡；巨大建筑物
casual	kæʒjuəl	a.偶然的；随便的
cat	kæt	n.猫，猫科，猫皮
catalog	kætəlɔg	n.目录，目录册
catch	kætʃ	vt.捉住；赶上；领会
cattle	kætl	n.牛；牲口，家畜
cause	kɔ:z	n.原因，理由；事业
cave	keiv	n.山洞，洞穴，窑洞
cease	si:s	vi.&vi.&n.停止，停息
ceiling	si:liŋ	n.天花板，顶蓬
celebrate	selibreit	vt.庆祝；歌颂，赞美
cell	sel	n.细胞；小房间
cement	si'ment	n.水泥；胶泥vt.粘结
cent	sent	n.分；分币；百
centimetre	sentimi:tə	n.公分，厘米
central	sentrəl	a.中心的；主要的
centre	sentə	n.中心；中枢vt.集中
century	sentʃuri	n.世纪，百年
ceremony	seriməni	n.典礼，仪式；礼节
certain	sə:tən	a.确实的；肯定的
certainly	sə:tənli	ad.一定，必定；当然
certificate	sə'tifikit	n.证书，证件，执照
chain	tʃein	n.链，链条，项圈
chair	tʃeə	n.椅子；主席
chairman	tʃeəmən	n.主席；议长，会长
chalk	tʃɔ:k	n.白垩；粉笔
challenge	tʃæləndʒ	n.挑战；要求，需要
chamber	tʃeimbə	n.会议室；房间；腔
champion	tʃæmpjən	n.冠军，得胜者
chance	tʃa:ns	n.机会，机遇；可能性
change	tʃeindʒ	n.改变，变化；零钱
channel	tʃænl	n.海峡；渠道；频道
chapter	tʃæptə	n.章，回，篇
character	kæriktə	n.性格；特性；角色
characteristic	kæriktə'ristik	a.特有的n.特性
charge	tʃa:dʒ	vt.索价；控告n.费用
chart	tʃa:t	n.图，图表；海图
chase	tʃeis	n.追逐，追赶，追求
cheap	tʃi:p	a.廉价的；劣质的
cheat	tʃi:t	vt.骗取；哄vi.行骗
check	tʃek	vt.检查；制止n.检查
cheek	tʃi:k	n.面颊，脸蛋
cheer	tʃiə	vt.使振作；欢呼
cheerful	tʃiəful	a.快乐的，愉快的
cheese	tʃi:z	n.乳酪，干酪
chemical	kemikl	a.化学的n.化学制品
chemist	kemist	n.化学家；药剂师
chemistry	kemistri	n.化学
cheque	tʃek	n.支票
chess	tʃes	n.棋；国际象棋
chest	tʃest	n.胸腔，胸膛；箱子
chew	tʃu:	vt.咀嚼，嚼碎
chicken	tʃikin	n.小鸡，小鸟；鸡肉
chief	tʃi:f	a.主要的；首席的
child	tʃaild	n.小孩，儿童；儿子
childhood	tʃaildhud	n.童年，幼年；早期
chill	tʃil	vt.使变冷n.寒冷
chimney	tʃimni	n.烟囱，烟筒；玻璃罩
chin	tʃin	n.颏，下巴
China	tʃainə	n.中国
china	tʃainə	n.瓷器，瓷料
Chinese	tʃai'ni:z	a.中国的n.中国人
chocolate	tʃɔkəlit	n.巧克力；巧克力糖
chɔice	tʃɔis	n.选择，抉择
choke	tʃəuk	vt.使窒息；塞满
choose	tʃu:z	vt.选择，挑选；情愿
chop	tʃɔp	vt.砍，劈；切细vi.砍
Christian	kristiən	n.基督教徒；信徒
Christmas	krisməs	n.圣诞节
church	tʃə:tʃ	n.教堂，礼拜堂；教会
cigarette	sigə'ret	n.香烟，纸烟，卷烟
cinema	sinimə	n.电影院；电影，影片
circle	sə:kl	n.圆，圆周；圈子
circuit	sə:kit	n.电路；环行；巡行
circular	sə:kjulə	a.圆的；循环的
circulate	sə:kjuleit	vt.使循环vi.循环
circumference	sə'kΛmfərəns	n.圆周，周长，圆周线
circumstance	sə:kəmstəns	n.情况，条件；境遇
citizen	sitizn	n.公民；市民，居民
city	siti	n.城市，都市
civil	sivl	a.公民的；文职的
civilization	sivilai'zeiʃən	n.文明，文化；开化
civilize	sivilaiz	vt.使文明；教育
claim	kleim	vt.声称，主张；索取
clap	klæp	vi.拍手vt.拍，轻拍
clarify	klærifai	vt.澄清，阐明
class	kla:s	n.班，班级；阶级
classical	klæsikəl	a.古典的；经典的
classification	klæsifi'keiʃən	n.分类；分级；分类法
classify	klæsifai	vt.把…分类
classmate	kla:smeit	n.同班同学
classroom	kla:srum	n.教室，课堂
claw	klɔ:	n.爪，脚爪，螯
clay	klei	n.粘土，泥土；肉体
clean	kli:n	a.清洁的；纯洁的
clear	kliə	a.清晰的vt.清除
clerk	kla:k,klə:k	n.店员；办事员，职员
clever	klevə	a.聪明的；机敏的
cliff	klif	n.悬崖，峭壁
climate	klaimit	n.气候；风土，地带
climb	klaim	vi.攀登，爬vt.爬
clock	klɔk	n.钟，仪表
close	kləuz,kləus	vt.关，闭；结束
cloth	klɔ:θ	n.布；衣料；桌布
clothe	kləuð	vt.给…穿衣服
clothes	kləuðz	n.衣服，服装；被褥
clothing	kləuðiŋ	n.衣服，被褥
cloud	klaud	n.云；云状物；阴影
cloudy	klaudi	a.多云的；云一般的
club	klΛb	n.俱乐部，夜总会
clue	klu:	n.线索，暗示，提示
clumsy	klΛmzi	a.笨拙的；愚笨的
coach	kəutʃ	n.长途公共汽车
coal	kəul	n.煤，煤块
coarse	kɔ:s	a.粗的，粗糙的
coast	kəust	n.海岸，海滨(地区)
coat	kəut	n.外套，上衣；表皮
cock	kɔk	n.公鸡；雄禽；旋塞
code	kəud	n.准则；法典；代码
coffee	kɔfi	n.咖啡，咖啡茶
cɔil	kɔil	n.(一)卷；线圈vt.卷
cɔin	kɔin	n.硬币；铸造(硬币)
cold	kəuld	a.冷的；冷淡的n.冷
collapse	kə'læps	vi.倒坍；崩溃，瓦解
collar	kɔlə	n.衣领，项圈
colleague	kɔli:g	n.同事，同僚
collect	kə'lekt	vt.收集vi.收款
collection	kə'lekʃən	n.搜集，收集；收藏品
collective	kə'lektiv	a.集体的；集合性的
college	kɔlidʒ	n.学院；大学
collision	kə'liʒ(ə)n	n.碰撞；冲突
colony	kɔləni	n.殖民地；侨居地
color	kΛlə	n.颜色，彩色；颜料
column	kɔləm	n.柱，支柱，圆柱
comb	kəum	n.梳子vt.梳理
combination	kɔmbi'neiʃən	n.结合，联合；化合
combine	kəm'bain	vt.使结合；兼有
come	kΛm	vi.来，来到；出现
comfort	kΛmfət	n.舒适；安慰vt.安慰
comfortable	kΛmfətəbl	a.舒适的，安慰的
command	kə'ma:nd	vt.命令，指挥；控制
commander	kə'ma:ndə	n.司令官，指挥员
comment	kɔment	n.评论，意见；注释
commerce	kɔmə(:)s	n.商业，贸易；社交
commercial	kə'mə:ʃəl	a.商业的；商品化的
commission	kə'miʃən	n.委任状；委员会
commit	kə'mit	vt.犯(错误);干(坏事)
committee	kə'miti	n.委员会；全体委员
common	kɔmən	a.普通的；共同的
communicate	kə'mju:nikeit	vi.通讯；传达；传播
communication	kə'mju:nikeiʃən	n.通讯；传达；交通
communism	kɔmjunizəm	n.共产主义
communist	kɔmjunist	n.共产党员
community	kə'mju:niti	n.社区；社会；公社
companion	kəm'pæniən	n.同伴；共事者；伴侣
company	kΛmpəni	n.公司，商号；同伴
comparative	kəm'pærətiv	a.比较的，相对的
compare	kəm'peə	vt.比较，对照；比作
comparison	kəm'pærisn	n.比较，对照；比似
compass	kΛmpəs	n.罗盘，指南针；圆规
compel	kəm'pel	vt.强迫，迫使屈服
compete	kəm'pi:t	vi.比赛；竞争；对抗
competent	kɔmpitənt	a.有能力的；应该做的
competition	kɔmpə'tiʃən	n.竞争，比赛
complain	kəm'plein	vi.抱怨，拆苦；控告
complaint	kəm'pleint	n.抱怨；怨言；控告
complete	kəm'pli:t	a.完整的；完成的
complex	kɔmpleks	a.结合的；复杂的
complicated	kɔmplikeitid	a.复杂的，难懂的
component	kəm'pəunənt	n.组成部分；分；组件
compose	kəm'pəuz	vt.组成，构成；创作
composition	kɔmpə'ziʃən	n.构成；作品；写作
compound	kɔmpaund,kəm'paund	n.化合物；复合词
comprehension	kɔmpri'henʃən	n.理解，理解力；领悟
comprehensive	kɔmpri'hensiv	a.广泛的；理解的
compress	kəm'pres	vt.压紧，压缩
comprise	kəm'praiz	vt.包含，包括；构成
compromise	kɔmprəmaiz	n.妥协，和解
compute	kəm'pju:t	vt.计算，估计，估算
computer	kəm'pju:tə	n.计算机，电脑
conceal	kən'si:l	vt.把…隐藏起来
concentrate	kɔnsəntreit	vt.集中；聚集；浓缩
concentration	kɔnsən'treiʃən	n.集中；专注；浓缩
concept	kɔnsept	n.概念，观念，设想
concern	kən'sə:n	n.关心，挂念；关系
concerning	kən'sə:niŋ	prep.关于
concert	kɔnsət	n.音乐会，演奏会
conclude	kən'klu:d	vt.推断出；结束
conclusion	kən'klu:ʒən	n.结论，推论；结尾
concrete	kɔnkri:t	n.混凝土；具体物
condemn	kən'dem	vt.谴责，指责；判刑
condense	kən'dens	vt.压缩，使缩短
condition	kən'diʃən	n.状况，状态；环境
conduct	kɔndəkt,kən'dΛkt	n.举止，行为；指导
conductor	kən'dΛktə	n.售票员；(乐队)指挥
conference	kɔnfərəns	n.会议，讨论会
confess	kən'fes	vt.供认，承认；坦白
confidence	kɔnfidəns	n.信任；信赖；信心
confident	kɔnfidənt	n.确信的，自信的
confine	kən'fain	vt.限制；禁闭
confirm	kən'fə:m	vt.证实，肯定；批准
conflict	kɔnflikt,kən'flikt	n.争论；冲突；斗争
confuse	kən'fju:z	vt.使混乱，混淆
congratulate	kən'grætjuleit	vt.祝贺，向…道喜
congress	kɔŋgres	n.大会；国会，议会
conjunction	kən'dʒΛŋkʃən	n.接合，连接；连接词
connect	kə'nekt	vt.连接，连结；联系
connection	kə'nekʃən	n.连接，联系；连贯性
conquer	kɔŋkə	vt.征服，战胜；破除
conquest	kɔŋkwest	n.攻取，征服；克服
conscience	kɔnʃəns	n.良心，道德心
conscious	kɔnʃəs	a.意识到的；有意的
consciousness	kɔnʃəsnis	n.意识，觉悟；知觉
consent	kən'sent	n.同意，赞成vi.同意
consequence	kɔnsikwəns	n.结果，后果
consequently	kɔnsikwəntli	ad.因此，因而，所以
conservation	kɔnsə(:)'veiʃən	n.保存，保护；守恒
conservative	kən'sə:vətiv	a.保守的n.保守的人
consider	kən'sidə	vt.认为；考虑；关心
considerable	kən'sidərəbl	a.相当大的；重要的
considerate	kən'sidərit	a.考虑周到的；体谅的
consideration	kənsidə'reiʃən	n.考虑，思考；体贴
consist	kən'sist	vi.由…组成；在于
consistent	kən'sistənt	a.坚持的，一贯的
constant	kɔnstənt	a.经常的；永恒的
constitute	kɔnstitju:t	vt.构成,组成,任命
constitution	kɔnsti'tju:ʃən	n.章程；体质；构造
construct	kən'strΛkt	vt.建造；建设；构筑
construction	kən'strΛkʃən	n.建造；建筑；建筑物
consult	kən'sΛlt	vt.请教，查阅
consume	kən'sju:m	vt.消耗，消费；消灭
consumption	kən'sΛmpʃən	n.消耗量；消耗
contact	kɔntækt,kən'tækt	vt.使接触；与…联系
contain	kən'tein	vt.包含，容纳；等于
container	kən'teinə	n.容器；集装箱
contemporary	kən'tempərəri	a.当代的，同时代的
contempt	kən'tempt	n.轻蔑；藐视；受辱
content	kɔntent,kən'tent	n.内容，目录；容量
content	kɔntent,kən'tent	a.满意的，满足的
contest	kən'test,'kɔntest	vt.争夺，争取；辩驳
continent	kɔntinənt	n.大陆；陆地；洲
continual	kən'tinjuəl	a.不断的；连续的
continue	kən'tinju(:)	vt.继续，连续；延伸
continuous	kən'tinjuəs	a.连续不断的，持续的
contract	kɔntrækt,kən'trækt	n.契约，合同；婚约
contradiction	kɔntrə'dikʃən	n.矛盾，不一致；否认
contrary	kɔntrəri	a.相反的n.相反
contrast	kɔntræst,kən'træst	n.对比，对照，悬殊
contribute	kən'tribju(:)t	vt.捐献，捐助；投稿
control	kən'trəul	vt.控制，克制n.控制
convenience	kən'vi:njəns	n.便利，方便；厕所
convenient	kən'vi:njənt	a.便利的；近便的
convention	kən'venʃən	n.习俗，惯例；公约
conventional	kən'venʃənl	a.普通的；习惯的
conversation	kɔnvə'seiʃən	n.会话，非正式会谈
conversely	kɔnvə:sli	ad.相反地
conversion	kən'və:ʃən	n.转变，转化；改变
convert	kən'və:t,'kɔnvə:t	vt.使转变；使改变
convey	kən'vei	vt.传送；运送；传播
convince	kən'vins	vt.使确信，使信服
cook	kuk	vt.烹调，煮vt.烧菜
cool	ku:l	a.凉的，冷静的
cooperate	kəu'ɔpəreit	vi.合作，协作；配合
coordinate	kəu'ɔdinit	vt.使协调，调节
cope	kəup	vi.对付，应付
copper	kɔpə	n.铜；铜币，铜制器
copy	kɔpi	n.抄件vt.抄写，复制
cord	kɔ:d	n.细绳，粗线，索
core	kɔ:	n.果实的心，核心
corn	kɔ:n	n.谷物；(英)小麦
corner	kɔ:nə	n.角；犄角；边远地区
corporation	kɔ:pə'reiʃən	n.公司，企业；社团
correct	kə'rekt	a.正确的vt.纠正
correspond	kɔris'pɔnd	vi.相符合；相当
corresponding	kɔris'pɔndiŋ	a.相应的；符合的
corridor	kɔridɔ:	n.走廊，回廊，通路
cost	kɔst	n.价格，代价；成本
costly	kɔstli	a.昂贵的；价值高的
cottage	kɔtidʒ	n.村舍，小屋
cotton	kɔtn	n.棉；棉线；棉布
cough	kɔf	vi.咳，咳嗽n.咳嗽
could	kud,kəd	aux.v.(can的过去式)
council	kaunsil	n.理事会，委员会
count	kaunt	vt.计算vi.数，计数
counter	kauntə	n.柜台；计数器
country	kΛntri	n.国家，国土；农村
countryside	kΛntrisaid	n.乡下，农村
county	kaunti	n.英国的郡，美国的县
couple	kΛpl	n.夫妇；(一)对；几个
courage	kΛridʒ	n.勇气，胆量，胆识
course	kɔ:s	n.课程；过程；一道菜
court	kɔ:t	n.法院，法庭；庭院
cousin	kΛzn	n.堂(或表)兄弟(姐妹)
cover	kΛvə	vt.盖，包括n.盖子
cow	kau	n.母牛，奶牛；母兽
crack	kræk	n.裂缝，裂纹vi.爆裂
craft	kra:ft	n.工艺；手艺，行业
crane	krein	n.起重机，摄影升降机
crash	kræʃ	vi.碰撞，坠落n.碰撞
crawl	krɔ:l	vi.爬，爬行
crazy	kreizi	a.疯狂的，荒唐的
cream	kri:m	n.奶油，乳脂；奶油色
create	kri(:)'eit	vt.创造；引起，产生
creative	kri(:)'eitiv	a.创造性的，创作的
creature	kri:tʃə	n.生物，动物，家畜
credit	kredit	n.信用贷款；信用
creep	kri:p	vi.爬行；缓慢地行进
crew	kru:	n.全体船员
crime	kraim	n.罪，罪行；犯罪
criminal	kriminl	n.犯人，罪犯，刑事犯
crisis	kraisis	n.危机；存亡之际
critic	kritik	n.批评家，爱挑剔的人
critical	kritikəl	a.决定性的；批评的
criticism	kritisizəm	n.批评；批判；评论
criticize	kritisaiz	vt.批评；评论；非难
crop	krɔp	n.农作物，庄稼；一熟
cross	krɔs	vt.穿过；使交叉
crowd	kraud	n.群；大众；一伙人
crown	kraun	n.王冠，冕；花冠
crude	kru:d	a.简陋的；天然的
cruel	kruəl	a.残忍的，残酷的
crush	krΛʃ	vt.压碎，碾碎；镇压
crust	krΛst	n.面包皮；硬外皮
cry	krai	vi.哭，哭泣；叫喊
crystal	kristl	n.水晶，结晶体；晶粒
cube	kju:b	n.立方形；立方
cubic	kju:bik	a.立方形的；立方的
cultivate	kΛltiveit	vt.耕；种植；培养
culture	kΛltʃə	n.文化，文明；教养
cup	kΛp	n.杯子；(一)杯；奖杯
cupboard	kΛbəd	n.碗柜，碗碟橱；食橱
cure	kjuə	vt.医治；消除n.治愈
curiosity	kjuəri'ositi	n.好奇，好奇心；珍品
curious	kjuəriəs	a.好奇的；稀奇古怪的
current	kΛrənt	a.当前的；通用的
curse	kə:s	n.诅咒，咒骂；天谴
curtain	kə:tn	n.帘，窗帘；幕(布)
curve	kə:v	n.曲线；弯vt.弄弯
cushion	kuʃən	n.垫子，坐垫，靠垫
custom	kΛstəm	n.习惯，风俗；海关
customer	kΛstəmə	n.顾客，主顾
cut	kΛt	vt.切，割，剪；减少
cycle	saikl	n自行车，循环
daily	'deili	adj.每日的按天计算的日常的adv.每日天天n.日报(复)工作样片
dairy	'dɛəri	n.牛奶场乳制品乳品店adj.牛奶的
dam	dæm	n.水坝水堤障碍物vt.筑坝抑制(情感）等
damage	'dæmidʒ	vt.损害毁坏n.(pl.)赔偿损坏毁坏损害
damp	dæmp	adj.潮湿的有湿气的n.毒气湿气丧气vt.呛抑制使潮湿vi.衰减
dance	dɑ:ns	vi.跳舞摇晃雀跃vt.使跳跃使某人以跳舞的方式进入n.舞跳舞舞蹈舞会舞步
danger	'deindʒə	n.危险危险事物
dangerous	'deindʒərəs	adj.危险的不安全的引起危险的
dare	dɛə	vt.&vi.&aux.v.敢竟敢敢于勇于面对n.敢挑战
daring	'dɛəriŋ	adj.大胆的勇敢的n.冒险精神
dark	dɑ:k	adj.暗的黑色的n.黑暗暗处
darling	'dɑ:liŋ	n.亲爱的人可爱的人可爱的物宠儿adj.可爱的亲爱的
dash	dæʃ	vt.使猛撞猛掷泼溅冲撞匆忙溅vi.猛冲猛撞n.猛冲冲撞破折号少量短跑冲劲
data	'deitə	n.(datum的复数)数据资料
date	deit	n.日期约会枣椰子vt.约会定...日期vi.追溯到n.[计算机]DOS命令：显示或设置系统日期
daughter	'dɔ:tə	n.女儿adj.与女儿有关的女性直系后代的
dawn	dɔ:n	n.黎明破晓开端vi.破晓逐渐明白
day	dei	n.(一)天白昼白天
daylight	'deilait	n.白昼日光黎明
dead	ded	adj.死的无生命的萧条的精疲力竭的用完的无趣的adv.完全地突然地直接地n.死者死
deadly	'dedli	adj.致命的致死的死一般的adv.非常地如死一般地
deaf	def	adj.聋的不愿听的
deal	di:l	n.买卖待遇交易协定份量vt.(dealtdealt[delt])处理应付分配给予
dear	diə	adj.严重的珍贵的亲爱的昂贵的衷心的adv.高价地热爱地n.亲爱的人可爱的人int.啊哎呀
death	deθ	n.死死亡灭亡死神
debate	di'beit	n.&vi.争论辩论商讨vt.争论思考
debt	det	n.债债务欠债负债状态义务罪过失
decade	'dekeid	n.十年十年期
decay	di'kei	vi.腐烂衰败n.腐烂衰退
deceit	di'si:t	n.欺骗欺诈诡计不诚实
deceive	di'si:v	vt.欺骗蒙蔽行骗vi.行骗
December	di'sembə	n.十二月
decent	'di:snt	adj.正派的体面的有分寸的得体的相当好的
decide	di'said	vt.&vi.决定决心解决作出抉择
decision	di'siʒən	n.决定决心果断决策
deck	dek	n.甲板舱面层面桥面楼层vt.装饰
declare	di'klɛə	vt.&vi.断言声明表明宣布申报
decorate	'dekəreit	vt.装饰装璜修饰授予某人奖章或其他奖状
decrease	"'di:kri:s,di:'kri:s"	vi.&n.减少减少
deduce	di'dju:s	vt.演绎推论推断溯源
deed	di:d	n.行为事迹功绩(尤指房产)契约证书vt.通过行为转化
deep	di:p	adj.深的有...深的深奥的纵深的adv.深深地晚地n.深处
deepen	'di:pən	vt.加深使...加深使...强烈vi.深化加深变浓
deer	diə	n.鹿
defeat	di'fi:t	vt.战胜击败挫败n.败北失败
defect	di'fekt	n.缺点缺陷欠缺vi.背叛
defence	di'fens	n.防御防务辩护答辩
defend	di'fend	vt.&vi.防护辩护防卫保卫防守
define	di'fain	vt.给...下定义限定解释
definite	'definit	adj.明确的肯定的一定的
definitely	'definitli	adv.一定地明确地确切地
definition	.defi'niʃən	n.定义释义定界阐释清晰度
degree	di'gri:	n.程度度度数学位
delay	di'lei	vt.推迟耽搁延误vi.耽搁n.耽搁迟滞
delete	di'li:t	vt.删除擦掉
delegation	.deli'geiʃən	n.代表团委派
delicate	'delikit	adj.纤细的易碎的精美的微妙的美味的脆弱的敏锐的n.精美的东西
delicious	di'liʃəs	adj.美味的可口的怡人的
delight	di'lait	n.快乐快乐vt.使高兴vi.给与乐趣
deliver	di'livə	vt.投递递送送交发表表达释放交付接生履行vi.达成
delivery	di'livəri	n.投递交付分娩
demand	di'mɑ:nd	vt.要求需要询问n.要求需求
democracy	di'mɔkrəsi	n.民主民主制民主国家
democratic	.demə'krætik	adj.民主的民主政体的大众的平等的
demonstrate	'demənstreit	vt.说明论证证明表露示范演示vi.示威
dense	dens	adj.密集的浓厚的愚钝的不易看透的
density	'densiti	n.密集稠密密度透明度
deny	di'nai	vt.否定拒绝相信拒绝反对克制
depart	di'pɑ:t	vi.离开起程出发死亡脱轨vt.离开
department	di'pɑ:tmənt	n.部司局处系部门省
departure	di'pɑ:tʃə	n.离开出发起程分歧
depend	di'pend	vi.依靠依赖相信指望
dependent	di'pendənt	adj.依靠的依赖的附属的悬垂的n.受经济援助者
deposit	di'pɔzit	vt.使沉淀存放堆积vi.沉淀n.存款定金堆积物
depress	di'pres	vt.使沮丧按下降低[计算机]降低
depth	depθ	n.深度深厚深处强度诚挚
derive	di'raiv	vt.取得得自起源引申于vi.起源
descend	di'send	vt.&vi.降传降临下来下降下倾
describe	di'skraib	vt.形容描写描绘描述画(尤指几何图形)
description	di'skripʃən	n.描写描述说明书作图形容种类
desert	"'dezət,di'zə:t"	n.沙漠荒地应得(的惩罚或奖励)vt.离弃擅离遗弃vi.擅离职守adj.沙漠的荒凉的
deserve	di'zə:v	vt.应受值得vi.应该得到
design	di'zain	vt.设计想像计划vi.计划设计n.设计图样
desirable	di'zaiərəbl	adj.值得相望的可取的值得有的令人满意的有吸引力的n.有吸引力的人
desire	di'zaiə	vt.要求向往请求渴望n.愿望欲望情欲
desk	desk	n.书桌办公桌
despair	di'spɛə	n.绝望失望vi.绝望失望
desperate	'despərit	adj.拼死的绝望的不顾一切的极想得到的
despise	di'spaiz	vt.鄙视蔑视
despite	di'spait	prep.不管尽管不顾v.憎恨轻视
destination	.desti'neiʃən	n.目的地终点目标景点
destroy	dis'trɔi	vt.&vi.破坏消灭打破[计算机]撤消
destruction	di'strʌkʃən	n.破坏毁灭消灭破坏者
detail	'di:teil	n.细节详情部分分派枝节零件vt.详述选派用小元素装饰vi.画细节
detect	di'tekt	vt.察觉发觉侦察发现探测信息vi.当侦探
detection	di'tekʃən	n.察觉发觉侦察探测
determination	di.tə:mi'neiʃən	n.决心(正式)决定确定规定测定定位
determine	di'tə:min	vt.决定查明决心[计算机]确定
develop	di'veləp	vt.发展形成开发冲洗照片vi.进步
development	di'veləpmənt	n.发展开发生长显影开发区
device	di'vais	n.器械装置设备设计策略
devil	'devl	n.魔鬼恶魔坏人难对付的东西困难小尘暴vt.加料惹恼
devise	di'vaiz	vt.设计发明遗赠n.遗赠(的财产)
devote	di'vəut	vt.将...奉献致力于投入于献身
dew	dju:	n.露露水
diagram	'daiəgræm	n.图解图表简图vt.用图解法表示
dial	'daiəl	n.钟面拨号盘刻度盘针面转盘vt.拨用仪表测量操作仪表vi.拨号用仪表测量[计算机]拨号
dialect	'daiəlekt	n.方言土语地方话
dialog	'daiəlɔg	n.对话对白(美)=dialogue
diameter	dai'æmitə	n.直径
diamond	'daiəmənd	n.金钢石钻石菱形像钻石的物质纸牌的方块棒球内场vt.用钻石装饰adj.60或75周年纪念的
diary	'daiəri	n.日记日记簿
dictate	"'dikteit,dik'teit"	vt.&vi.口授命令听写n.命令指挥指令
dictation	dik'teiʃən	n.口授笔录听写
dictionary	'dikʃəneri	n.词典字典辞典
die	dai	vi.死死亡灭亡n.金属模子印模骰子
differ	'difə	vi.不同(意见)相异不一致
difference	'difərəns	n.差别差分歧vt.引起区别
different	'difərənt	adj.差异的各种的不同的与众不同的
difficult	'difikəlt	adj.困难的难对付的(人)难取悦的难相处的
difficulty	'difikəlti	n.困难争议反对麻烦难事困境
dig	dig	vt.掘挖翻土采掘
digest	dai'dʒest	vt.消化领会理解vi.消化n.文摘摘要
digital	'didʒitəl	adj.数字的计数的手指的数码的电子的
diligent	'dilidʒənt	adj.勤勉的勤奋的用功的
dim	dim	adj.昏暗的暗淡的朦胧的模糊的笨的vt.使暗淡使失去光泽vi.变暗n.车头灯的短焦距光
dimension	di'menʃən	n.尺寸尺度面积次元容积维度范围方面vt.标尺寸形成...尺寸
dinner	'dinə	n.正餐主餐宴会晚宴
dip	dip	vt.浸蘸给...洗药浴vi.浸一浸下降向下倾斜翻阅提取(款项)n.游下降减少低洼处调味酱药浴液
direct	di'rekt	adj.直接的直率的笔直的坦白的vt.指挥命令负责vi.指导指出
direction	di'rekʃən	n.方向方位指导用法说明趋势
directly	di'rektli	adv.直接地立即完全
director	"di'rektə,dai'rektə"	n.指导者理事董事经理主管导演
dirt	də:t	n.尘土污物污垢泥土污秽的言行卑鄙的人堕落矿渣
dirty	'də:ti	adj.脏的下流的肮脏的色情的卑鄙的adv.卑鄙地vt.使...变脏vi.弄脏
disable	dis'eibl	vt.使无能使伤残使...失去能力
disadvantage	.disəd'væntidʒ	n.不利不利地位不利条件损害损失
disagree	.disə'gri:	vi.有分歧不一致不适应不适宜
disappear	.disə'piə	vi.不见失踪消失灭绝vt.引起消失
disappoint	.disə'pɔint	vt.&vi.使失望使受挫折
disaster	di'zɑ:stə	n.灾难灾祸天灾
disk	disk	n.圆盘唱片磁盘光盘花盘盘形物[计算机]磁盘vt.用圆盘耙耙地
discard	"'diskɑ:d,dis'kɑ:d"	vt.丢弃抛弃遗弃vi.丢牌n.丢牌废牌
discharge	dis'tʃɑ:dʒ	vt.vi.释放排出放出解雇解除放电清偿债务n.释放卸货放电一股一阵开火发射准许离开
discipline	'disiplin	n.纪律训练惩罚学科vt.训练惩罚
disclose	dis'kləuz	vt.揭开揭发透露
discourage	dis'kʌridʒ	vt.使泄气使灰心阻碍
discover	dis'kʌvə	vt.&vi.发现暴露显示
discovery	dis'kʌvəri	n.发现被发现的事物
discuss	di'skʌs	vt.讨论谈论论述
discussion	di'skʌʃən	n.讨论谈论辩论论述
disease	di'zi:z	n.病疾病病害弊端
disguise	dis'gaiz	vi.隐瞒掩埋vt.假装假扮掩饰n.假装假面目伪装物
disgust	dis'gʌst	n.厌恶憎恶嫌恶vt.&vi.令人厌恶
dish	diʃ	n.碟盘子菜肴凹形vt.装盘提出揭露挖空vi.闲谈
dishonour	dis'ɔnə	n.不光彩丢脸的人耻辱拒付vt.使丢脸侮辱拒付=dishonor
dislike	dis'laik	vt.&n.不喜爱厌恶反感
dismiss	dis'mis	vt.不再考虑解雇解散开除逃避(法律)驳回
disorder	dis'ɔ:də	n.混乱杂乱骚乱vt.扰乱
display	di'splei	vt.陈列展览显示炫耀vt.显示表现夸示
disposal	di'spəuzəl	n.丢掉处理销毁菜碾碎器
dispose	di'spəuz	vi.去掉丢掉销毁vt.倾向于处置
displease	dis'pli:z	vt.使不愉快使生气
dispute	di'spju:t	vi.争论争执vt.争论质疑争夺抵抗n.争论争吵
dissatisfy	dis'sætisfai	vi.使不满使不平
dissolve	di'zɔlv	vt.使溶解解散消除解决(问题)使沮丧vi.消散溶解解散液化变得模糊n.叠化画面
distance	'distəns	n.距离间距远处(人际关系的)疏远vt.使疏远把(对手)甩在后面与...保持距离adj.(通过电子手段)远程(教育)
distant	'distənt	adj.在远处的疏远的疏远的远房的陌生的远行的
distinct	di'stiŋkt	adj.与其他不同的不同的明显的(from)独特的清楚的
distinction	di'stiŋkʃən	n.差别不同区分对比杰出
distinguish	di'stiŋgwiʃ	vt.区别辨别认别特别关注vi.区别
distress	di'stres	n.忧虑悲伤不幸苦恼贫困忧郁恶化扣押财物vt.使...苦恼仿造adj.亏本出售的
distribute	di'stribjut	vt.&vi.分发分送分布分配
distribution	.distri'bju:ʃən	n.分发分配分布散布
district	'distrikt	n.区地区区域行政区vt.划分区域划分地区
disturb	dis'tə:b	vt.&vi.打扰扰乱弄乱妨碍使...不安
ditch	ditʃ	n.沟沟渠渠道vt.坠入沟中摆脱飞机(在海上)迫降vi.挖一条沟渠飞机紧急降落
dive	daiv	vi.跳水潜水俯冲vt.跳水俯冲vi.把...伸入
diverse	dai'və:s	adj.不一样的相异的不同的多种多样的
divide	di'vaid	vt.分分配分开(组)vi.除分开
division	di'viʒən	n.分分配除法划分分开部门师(军队)
divorce	di'vɔ:s	n.离婚离异vi.离婚与...办离婚
do	du:	aux.v.vt.&vi.做干办
dock	dɔk	n.船坞码头(造)修船厂尾巴的骨肉部分被告席vt.进港(减)剪短对接vi.进港对接
doctor	'dɔktə	n.医生医师博士vt.医治篡改对...做手脚vi.用药
document	"'dɔkjumənt,'dɔkjument"	n.公文文件证件[计算机]文档vt.记载用文件等证明
dog	dɔg	n.狗犬犬科动物卑鄙的人vt.尾随跟踪
dollar	'dɔlə	n.美元(货币单位)
domestic	də'mestik	adj.本国的国内的家庭的驯养的n.家仆佣人
donkey	'dɔŋki	n.驴笨蛋
door	dɔ:	n.门通道一家
dorm	dɔ:m	n.(集体)宿舍
dormitory	'dɔ:mitri	n.集体寝室宿舍
dose	dəus	n.剂量用量一剂vt.配
dot	dɔt	n.点圆点少量小东西vt.作小点记号点缀vi.作小点记号[计算机]点
double	'dʌbl	adj.两倍的复制品替身双重角色的演员反转双的双人房adj.两倍的双重的骗人的加量的adv.两倍地双人地翻来覆去地对折地vt.使加倍对折握紧做替身vi.加倍转身兼任替代演出
doubt	daut	n.怀疑疑虑不信任vt.怀疑不信任vi.不确定
doubtful	'dautfəl	adj.难以预测的怀疑的疑心的不确定的
doubtless	'dautlis	adv.无疑地很可能确定地adj.无疑的确定的
down	daun	adv.向下在下面下跌在南方adj.向下的降低的情绪低落停止运行n.绒毛汗毛轻视prep.沿着...而下
downstairs	.daun'stɛəz	adv.在楼下向楼下adj.楼下的n.楼下
downward	'daunwəd	adj.向下的adv.向下地
dozen	'dʌzn	n.一打十二个adj.一打的十二个的
draft	dræft	n.草稿草图汇票徵兵vt.起草征兵选秀adj.酝酿中的
drag	dræg	vt.拖拉拖曳拖累拖拉(动)vi.拖拉(动)缓慢地行走n.用来拖拉的东西拖拖累
dragon	'drægən	n.龙凶暴的人严厉的人
drain	drein	vt.排去放水耗尽排出排干喝光vi.变干排出排水n.下水道排水沟消耗耗竭
drama	'drɑ:mə	n.一出戏剧剧本戏剧戏剧性情节刺激
dramatic	drə'mætik	adj.引人注目的戏剧的给人深刻印象的n.(pl.)戏剧作品戏曲
dramatization	.dræməti'zeiʃən	n.编剧改编成戏剧
draw	drɔ:	vt.(drewdrawn)拉拖挨近提取画绘制划拨出n.平局抽签拉拽吸引人的事物
drawer	'drɔ:ə	n.抽屉
drawing	'drɔ:iŋ	n.图画素描绘图绘图技巧
dread	dred	n.畏惧恐怖可怕的人可怕的事vt.惧怕恐惧adj.可怕的可怖的
dream	dri:m	n.梦梦想vt.&vi.做梦想象
dress	dres	n.女服童装服装vt.&vi.穿著adj.正式的(衣服)
drift	drift	vi.漂流漂泊吹积n.漂流漂移漂流物观望吹积物趋势vt.使漂流把...吹积
drill	dril	n.钻头钻孔机钻子播种机操练vi.钻孔vt.训练钻孔
drink	driŋk	vt.&vi.饮喝喝酒n.饮料
drip	drip	vi.滴下漏水n.水滴滴点滴乏味的人
drive	draiv	vt.&vi.驾驶驱驱使驾进力打入n.驾车快车道推进力驱使路街[计算机]驱动器
driver	'draivə	n.驾驶员司机
drop	drɔp	vt.使落下降低减少vi.落下减少减弱n.滴微量落下
drought	draut	n.旱灾干旱
drown	draun	vi.淹死溺死vt.淹死沉浸于
drug	drʌg	n.药药物药材毒品vt.下药使...服麻醉药vi.吸毒
drum	drʌm	n.鼓鼓声鼓状物圆桶冰丘vi.击鼓作鼓声引起兴趣vt.召集入伍逐出(经过努力)推动...连续击打
drunk	drʌŋk	adj.醉的陶醉的vbl.喝喝酒
dry	drai	adj.干的干燥的干旱的不行于色的枯燥无味的无酒的口渴的vt.把...弄干vi.(使)变干
duck	dʌk	n.鸭雌鸭鸭肉板球零分vt.把…按入水中低头弯身(以免被打中或看见)躲避vi.迅速行进飞快行走(以免被看见)推委责任
due	dju:	adj.预期的应给的到期的应有的预定的n.应得物
dull	dʌl	adj.枯燥的不鲜明的呆滞的迟钝的无趣的钝的暗的vt.使变钝vi.变钝
dumb	dʌm	adj.哑的无言的沉默的愚蠢的vt.使人沉默
dump	dʌmp	vt.倾卸倾倒倾销丢弃抛售导出vi.骤降扔垃圾n.垃圾场堆放处
durable	'djuərəbl	adj.耐久的耐用的n.(复)耐用品
duration	dju'reiʃən	n.持续持久持续时间期间
during	'djuəriŋ	prep.在...期间
dusk	dʌsk	n.薄暮黄昏幽暗vi.(天)变黑变暗vt.把…变黑变暗adj.颜色暗沉的昏暗的
dust	dʌst	n.尘土灰尘无价值之物屈辱状态vt.拂去灰尘撒上粉状物体大胜vi.擦拭灰尘
duty	'dju:ti	n.职责责任义务税adj.值班的作为一种义务的
dwelling	'dweliŋ	n.住处寓所
dye	dai	vt.染vi.染色n.染料染色
dying	'daiiŋ	adj.垂死的临终的n.死死亡
dynamic	dai'næmik	adj.有活力的动态的(有)动力的(有)力的n.动力力学
each	i:tʃ	pron.各，各自a.各
eager	i:gə	a.渴望的，热切的
eagle	i:gl	n.鹰
ear	iə	n.耳朵；听力，听觉
early	ə:li	ad.早a.早的，早期的
earn	ə:n	vt.赚得，挣得；获得
earnest	ə:nist	a.认真的，诚恳的
earth	ə:θ	n.地球；陆地，地面
earthquake	ə:θkweik	n.地震；大震荡
ease	i:z	n.容易，舒适vt.缓和
east	i:st	n.东；东部ad.在东方
eastern	i:stən	a.东方的；朝东的
easy	i:zi	a.容易的；安逸的
eat	i:t	vt.吃，喝vi.吃饭
echo	ekəu	n.回声，反响vi.重复
econɔmic	i:kə'nɔmik	a.经济的，经济学的
economical	i:kə'nɔmikəl	a.节约的；经济学的
economy	i(:)'kɔnəmi	n.经济；节约，节省
edge	edʒ	n.边缘，边；刀口
edition	i'diʃən	n.版，版本，版次
editor	editə	n.编辑，编者，校订者
educate	edju(:)keit	vt.教育；培养；训练
education	edju:'keiʃən	n.教育；训导；教育学
effect	i'fekt	n.结果；效果，效力
effective	i'fektiv	a.有效的；有影响的
efficiency	i'fiʃənsi	n.效率；功效，效能
efficient	i'fiʃənt	a.效率高的，有能力的
effort	efət	n.努力；努力的成果
egg	eg	n.蛋，鸡蛋，卵
eight	eit	num.八，八个，第八
eighteen	ei'ti:n	num.十八，十八个
eighth	eitθ	num.第八n.八分之一
eighty	eiti	num.八十，八十个
either	aiðə,'i:ðə	pron.(两者)任何一个
elaborate	i'læbərit	a.复杂的；精心制作的
elastic	i'læstik	n.松紧带a.有弹性的
elder	eldə	a.年龄较大的n.长者
elect	i'lekt	vt.选举，推选；选择
election	i'lekʃən	n.选举，选择权；当选
electric	i'lektrik	a.电的，电动的
electrical	i'lektrikəl	a.电的，电气科学的
electricity	ilek'trisiti	n.电，电学；电流
electron	i'lektrɔn	n.电子
electronic	ilek'trɔnik	a.电子的
element	elimənt	n.成分；要素；元素
elementary	eli'mentəri	a.基本的；初级的
elephant	elifənt	n.象
elevator	eliveitə	n.电梯；升降机
eleven	i'levn	num.十一，十一个
eliminate	i'limineit	vt.消灭，消除，排除
else	els	ad.其它，另外a.别的
elsewhere	els'weə	ad.在别处，向别处
embarrass	im'bærəs	vt.使窘迫，使为难
embrace	im'breis	vt.拥抱；包括；包围
emerge	i'mə:dʒ	vi.出现，涌现；冒出
emergency	i'mə:dʒənsi	n.紧急情况，突然事件
emit	i'mit	vt.散发；发射；发表
emotion	i'məuʃən	n.情感，感情；激动
emotional	i'məuʃənl	a.感情的，情绪的
emperor	empərə	n.皇帝
emphasis	emfəsis	n.强调，重点，重要性
emphasize	emfəsaiz	vt.强调，着重
empire	empaiə	n.帝国
employ	im'plɔi	vi.雇用；用；使忙于
employee	emplɔi'i:	n.受雇者，雇员，雇工
employer	im'plɔiə	n.雇佣者，雇主
employment	im'plɔimənt	n.工业；雇用；使用
empty	empti	a.空的；空洞的
enable	i'neibl	vt.使能够，使可能
enclose	in'kləuz	vt.围住，圈起；附上
encounter	in'kauntə	vt.遭遇，遇到n.遭遇
encourage	in'kΛridʒ	vt.鼓励，支持，助长
end	end	n.末端；目标vt.结束
ending	endiŋ	n.结尾，结局；死亡
endless	endlis	a.无止境的
endure	in'djuə	vt.忍受；容忍
enemy	enimi	n.敌人；仇敌；敌兵
energy	enədʒi	n.活力；精力；能
enforce	in'fɔ:s	vt.实施，执行；强制
engage	in'geidʒ	vt.使从事于；聘用
engine	endʒin	n.发动机，引擎；机车
engineer	endʒi'niə	n.工程师，技师
engineering	endʒi'niəriŋ	n.工程，工程学
enlarge	in'la:dʒ	vt.扩大，扩展；放大
enormous	i'nɔ:məs	a.巨大的，庞大的
enough	i'nΛf	a.足够的ad.足够地
enquire	in'kwaiə	vi.vt.询问
enquiry		n.询问
ensure	in'ʃuə	vt.保证；保护；赋予
entertain	entə'tein	vt.使欢乐；招待
enthusiasm	in'θju:ziæzəm	n.热情，热心，热忱
entitle	in'taitl	vt.给…权利(或资格)
entry	entri	n.入口处；登记；进入
environment	in'vaiərənmənt	n.环境，外界；围绕
envy	envi	vt.&n.妒忌；羡慕
equal	i:kwəl	a.相等的；平等的
equality	i(:)'kwɔliti	n.等同，平等；相等
equation	i'kweiʃən	n.方程(式)；等式
equip	i'kwip	vt.装备，配备
equipment	i'kwipmənt	n.装备，设备，配备
equivalent	i'kwivələnt	a.相等的；等量的
era	iərə	n.时代，年代；纪元
erect	i'rekt	vt.建造；使竖立
error	erə	n.错误，谬误；差错
escape	is'keip	vi.逃跑；逸出n.逃跑
especially	is'peʃəli	ad.特别，尤其，格外
essay	esei	n.短文，散文，小品文
essential	i'senʃəl	a.必要的，本质的
establish	is'tæbliʃ	vt.建立，设立；确立
establishment	is'tæbliʃmənt	n.建立，设立，确立
estimate	estimit,'estimeit	vt.估计，评价n.估计
əurope	juərəp	n.欧洲
əuropean	juərə'pi:ən	a.欧洲的n.欧洲人
evaluate	i'væljueit	vt.评价，估…的价
evaporate	i'væpəreit	vt.使蒸发vi.蒸发
eve	i:v	n.前夜，前夕，前一刻
even	i:vən	ad.甚至；甚至更，还
even	i:vən	a.均匀的；平的
evening	i:vniŋ	n.傍晚，黄昏，晚上
event	i'vent	n.事件，大事；事变
eventually	i'ventjuəli	ad.终于；最后
ever	evə	ad.在任何时候；曾经
every	evri	a.每一的；每隔…的
everybody	evribɔdi	pron.每人，人人
everyday	evridei	a.每天的，日常的
everyone	evriwΛn	pron.每人，人人
everything	evriθiŋ	pron.每件事，事事
everywhere	evriweə	ad.到处，处处
evidence	evidəns	n.根据；证据，证人
evident	evidənt	a.明显的，明白的
evil	i:vl	n.邪恶；祸害a.坏的
evolution	i:və'lju:ʃən	n.进化，演化；发展
evolve	i'vɔlv	vt.使进化；使发展
exact	ig'zækt	a.确切的；精确的
exaggerate	ig'zædʒəreit	vt.&vi.夸大，夸张
exam	ig'zæm	n.考试；检查，细查
examination	igzæmi'neiʃən	n.考试；检查，细查
examine	ig'zæmin	vt.检查，仔细观察
example	ig'za:mpl	n.例子，实例；模范
exceed	ik'si:d	vt.超过，胜过；超出
exceedingly	ik'si:diŋli	ad.极端地，非常
excellent	eksələnt	a.优秀的，杰出的
except	ik'sept	prep.除…之外
exception	ik'sepʃən	n.例外，除外
excess	ik'ses,'ekses	n.超越；过量；过度
excessive	ik'sesiv	a.过多的，极度的
exchange	iks'tʃeindʒ	vt.交换；交流n.交换
excite	ik'sait	vt.使激动；引起
exciting	ik'saitiŋ	a.令人兴奋的
exclaim	iks'kleim	vi.呼喊；惊叫
exclude	iks'klu:d	vt.把…排除在外
exclusively	iks'klu:sivli	ad.专门地
excursion	iks'kə:ʃən	n.远足；短途旅行
excuse	iks'kju:z,iks'kju:s	vt.原谅；免除n.借口
execute	eksikju:t	vt.将…处死；实施
executive	ig'zekjutiv	a.执行的n.执行者
exercise	eksəsaiz	n.锻炼，训练vi.练习
exert	ig'zə:t	vt.尽(力)，运用
exhaust	ig'zɔ:st	vt.使筋疲力尽；用尽
exhibit	ig'zibit	vt.显示；陈列，展览
exhibition	eksi'biʃən	n.展览，陈列；展览会
exist	ig'zist	vi.存在；生存，生活
existence	ig'zistəns	n.存在，实在；生存
exit	eksit	n.出口；退场vi.退出
expand	iks'pænd	vt.扩大；使膨胀
expansion	iks'pænʃən	n.扩大，扩充；扩张
expect	iks'pekt	vt.预料，预期；等待
expectation	ekspek'teiʃən	n.期待，期望，预期
expense	iks'pens	n.花费，消费；费用
expensive	iks'pensiv	a.昂贵的，花钱多的
experience	iks'piəriəns	n.经验，感受；经历
experiment	iks'perimənt	n.实验；试验
experimental	iksperi'mentl	a.实验的，试验的
expert	ekspə:t	n.专家a.熟练的
explain	iks'plein	vt.解释；为…辩解
explanation	eksplə'neiʃən	n.解释，说明；辩解
explode	iks'pləud	vt.使爆炸vi.爆炸
explɔit	eksplɔit,iks'plɔit	vt.剥削；利用；开拓
explore	iks'plɔ:	vt.&vi.探险，探索
explosion	iks'pləuʒən	n.爆炸，爆发，炸裂
explosive	iks'pləusiv	n.炸药a.爆炸的
export	eks'pɔ:t,'ekspɔ:t	vt.输出，出口；运走
expose	iks'pəuz	vt.使暴露；揭露
exposure	iks'pəuʒə	n.暴露；揭露；曝光
express	iks'pres	vt.表示n.快车，快递
expression	iks'preʃən	n.词句；表达；表情
extend	iks'tend	vt.延长；扩大；致
extension	iks'tenʃən	n.延长部分；伸展
extensive	iks'tensiv	a.广阔的；广泛的
extent	iks'tent	n.广度；范围；程度
exterior	eks'tiəriə	a.外部的；对外的
external	eks'tə:nl	a.外部的，外面的
extra	ekstrə	a.额外的ad.特别地
extraordinary	iks'trɔ:dinəri	a.非同寻常的，特别的
extreme	iks'tri:m	a.极度的；尽头的
eye	ai	n.眼睛；眼力；鉴赏力
eyesight	aisait	n.视力，目力
fabric	fæbrik	n.织物，纺织品；结构
face	feis	n.脸；表面；外表
facility	fə'siliti	n.设备；容易；便利
fact	fækt	n.事实；实际，实情
factor	fæktə	n.因素；因子，系数
factory	fæktəri	n.工厂，制造厂
faculty	fækəlti	n.才能，能力；系，科
fade	feid	vi.褪色；逐渐消失
fail	feil	vi.失败；失灵；不能
failure	feiljə	n.失败；失败的人
faint	feint	a.微弱的；虚弱的
fair	feə	a.公平的；相当的
fair	feə	n.定期集市；博览会
fairly	feəli	ad.相当；公平地
faith	feiθ	n.信任，信心；信仰
faithful	feiθful	a.忠诚的；如实的
fall	fɔ:l	vi.落下；跌倒；陷落
FALSE	fɔ:ls	a.不真实的；伪造的
fame	feim	n.名声，名望
familiar	fə'miljə	a.熟悉的；冒昧的
family	fæmili	n.家，家庭；家族
famine	fæmin	n.饥荒；严重的缺乏
famous	feiməs	a.著名的，出名的
fan	fæn	n.(运动等)狂热爱好者
fan	fæn	n.扇子，风扇vt.扇
fancy	fænsi	n.想象力；设想；爱好
far	fa:	a.远的ad.远，遥远
fare	feə	n.车费，船费，票价
farewell	feə'wel	int.再会n.告别
farm	fa:m	n.农场，农庄；饲养场
farmer	fa:mə	n.农民，农夫；农场主
farther	fa:ðə	ad.更远地a.更远的
fashion	fæʃən	n.样子，方式；风尚
fashionable	fæʃənəbl	a.流行的，时髦的
fast	fa:st	a.快的；偏快的ad.快
fasten	fa:sn	vt.扎牢，扣住
fat	fæt	n.脂肪,肥肉a.肥胖的
fatal	feitl	a.致命的；命运的
fate	feit	n.命运，天数
father	fa:ðə	n.父亲；神父；创始人
fatigue	fə'ti:g	n.疲劳，劳累
fault	fɔ:lt	n.缺点；过失；故障
faulty	fɔ:lti	a.有错误的，有缺点的
favour	feivə	n.好感；赞同；恩惠
favourable	feivərəbl	a.有利的；赞成的
favourite	feivərit	a.特别受喜爱的
fear	fiə	n.害怕；担心vt.害怕
fearful	fiəful	a.害怕的，可怕的
feasible	fi:zəbl	a.可行的；可能的
feather	feðə	n.羽毛；翎毛；羽状物
feature	fi:tʃə	n.特征，特色；面貌
february	februəri	n.二月