sound	saund	a.健康的；完好的
lunch	lΛntʃ	n.午餐，(美)便餐
create	kri(:)'eit	vt.创造；引起，产生
attend	ə'tend	vt.出席；照顾，护理
read	ri:d	vt.读，看懂vi.读
couple	kΛpl	n.夫妇；(一)对；几个
anchor	æŋkə	n.锚vi.抛锚，停泊
valid	vælid	a.有效的；正当的
assure	ə'ʃuə	vt.使确信；向…保证
staff	sta:f	n.工作人员；参谋
local	ləukəl	a.地方的；局部的
lover	lΛvə	n.爱好者；情人；情侣
female	fi:meil	n.雌性的动物；女子
during	'djuəriŋ	prep.在...期间
change	tʃeindʒ	n.改变，变化；零钱
adapt	ə'dæpt	vt.使适应；改编
pound	paund	vt.捣碎；舂烂；猛击
steep	sti:p	a.险峻的，陡峭的
image	imidʒ	n.像；形象；映象
push	puʃ	vt.推，逼迫vi.推
chɔice	tʃɔis	n.选择，抉择
ooman	rəumən	n.古罗马人a.罗马的
occur	ə'kə:	vi.发生；出现，存在
stove	stəuv	n.炉，火炉，电炉
awake	ə'weik	a.醒着的vt.唤醒
flash	flæʃ	n.闪光vi.闪，闪烁
spɔil	spɔil	vt.损坏，糟蹋；宠坏
hedge	hedʒ	n.篱笆，树篱；障碍物
impact	impækt	n.影响，作用；冲击
smart	sma:t	a.巧妙的；洒脱的
abuse	ə'bju:z,ə'bju:s	vt.滥用；虐待n.滥用
inner	inə	a.内部的；内心的
clerk	kla:k,klə:k	n.店员；办事员，职员
nerve	nə:v	n.神经；勇敢，胆量
bother	bɔðə	vt.烦扰，迷惑n.麻烦
grand	grænd	a.宏伟的；重大的
device	di'vais	n.器械装置设备设计策略
chance	tʃa:ns	n.机会，机遇；可能性
crack	kræk	n.裂缝，裂纹vi.爆裂
formal	fɔ:məl	a.正式的；礼仪上的
birth	bə:θ	n.分娩，出生；出身
cousin	kΛzn	n.堂(或表)兄弟(姐妹)
glory	glɔ:ri	n.光荣；荣誉的事
judge	dʒΛdʒ	n.法官；裁判员
plain	plein	n.平原a.清楚的
beast	bi:st	n.兽，野兽；牲畜
floor	flɔ:	n.地板；楼层
europe	juərəp	n.欧洲
enemy	enimi	n.敌人；仇敌；敌兵
sheet	ʃi:t	n.被单；纸张；薄板
metal	metl	n.金属，金属制品
deadly	'dedli	adj.致命的致死的死一般的adv.非常地如死一般地
cover	kΛvə	vt.盖，包括n.盖子
widow	widəu	n.寡妇
whip	wip	vt.鞭笞；搅打n.鞭子
rack	ræk	n.搁物架；行李架vt.使苦痛，折磨
nurse	nə:s	n.保姆；护士vt.看护
light	lait	n.光，光线；灯，光源a.轻的，少量的
rebel	rebəl,ri'bel	vi.造反n.造反者
chair	tʃeə	n.椅子；主席
hurry	hΛri	vi.赶紧vt.催促
donkey	'dɔŋki	n.驴笨蛋
input	input	n.输入；投入的资金
erect	i'rekt	vt.建造；使竖立
cheese	tʃi:z	n.乳酪，干酪
depend	di'pend	vi.依靠依赖相信指望
honour	ɔnə	n.光荣；尊敬，敬意
happy	hæpi	a.快乐的；幸福的
rough	rΛf	a.表面不平的；粗略的
pitch	pitʃ	n.沥青vt.投，掷vi.投掷
tidy	taidi	a.整洁的；整齐的
effort	efət	n.努力；努力的成果
Latin	lætin	a.拉丁的n.拉丁语
dense	dens	adj.密集的浓厚的愚钝的不易看透的
swift	swift	a.快的；反应快的
expert	ekspə:t	n.专家a.熟练的
clumsy	klΛmzi	a.笨拙的；愚笨的
apart	ə'pa:t	ad.相隔；分开；除去
sore	sɔ:	a.痛的；恼火的n.疮
elect	i'lekt	vt.选举，推选；选择
model	mɔdl	n.模型；模式；模特儿
error	erə	n.错误，谬误；差错
bench	bentʃ	n.长凳，条凳；工作台
undo	Λn'du:	vt.解开，打开；取消
grasp	gra:sp	vt.抓紧；掌握n.抓
blood	blΛd	n.血，血液；血统
prize	praiz	n.奖赏，奖金vt.珍视
steel	sti:l	n.钢，钢铁
urge	ə:dʒ	vt.推进；催促n.冲动
escape	is'keip	vi.逃跑；逸出n.逃跑
ankle	æŋkl	n.踝，踝节部
hotel	həu'tel	n.旅馆
blind	blaind	a.瞎的；盲目的
drunk	drʌŋk	adj.醉的陶醉的vbl.喝喝酒
quote	kwəut	vt.引用，引证；报价
photo	fəutəu	n.照片，相片
spur	spə:	n.刺激物vt.刺激
atomic	ə'tɔmik	a.原子的；原子能的
finger	fiŋgə	n.手指；指状物
x-ray	eks'rei	n.X射线，X光
bring	briŋ	vt.带来；引出；促使
coarse	kɔ:s	a.粗的，粗糙的
clothe	kləuð	vt.给…穿衣服
brush	brΛʃ	n.刷子，毛刷；画笔
bright	brait	a.明亮的；聪明的
rear	riə	n.后部，后面；背面vt.抚养，培养；栽种
ready	redi	a.准备好的；愿意的
giant	dʒaiənt	n.巨人；巨物
vivid	vivid	a.鲜艳的；生动的
fluent	flu(:)ənt	a.流利的，流畅的
faith	feiθ	n.信任，信心；信仰
minor	mainə	a.较小的；较次要的
straw	strɔ:	n.稻草，麦杆吸管
court	kɔ:t	n.法院，法庭；庭院
brain	brein	n.脑，脑髓；脑力
compel	kəm'pel	vt.强迫，迫使屈服
cattle	kætl	n.牛；牲口，家畜
trust	trΛst	n.信任vt.相信；委托
trend	trend	vi.伸向；倾向n.倾向
legal	li:gl	a.法律的；合法的
deduce	di'dju:s	vt.演绎推论推断溯源
fairly	feəli	ad.相当；公平地
fasten	fa:sn	vt.扎牢，扣住
break	breik	vt.打破；损坏；破坏
before	bi'fɔ:	prep.在…以前；向…
ratio	reiʃiəu	n.比，比率
tide	taid	n.潮，潮汐；潮流
delete	di'li:t	vt.删除擦掉
lodge	lɔdʒ	vi.暂住，借宿，投宿
exceed	ik'si:d	vt.超过，胜过；超出
strip	strip	vt.剥；夺去n.条带
assume	ə'sju:m	vt.假定；承担；呈现
strap	stræp	n.带子vt.捆扎
youth	ju:θ	n.青春；青年们；青年
stem	stem	n.茎，(树)干vi.起源
limit	limit	n.限度；限制；范围
awful	ɔ:ful	a.令人不愉快的
elder	eldə	a.年龄较大的n.长者
worm	wə:m	n.虫，蠕虫
purse	pə:s	n.钱包，小钱袋，手袋
gallon	gælən	n.加仑
desire	di'zaiə	vt.要求向往请求渴望n.愿望欲望情欲
level	levl	n.水平面a.水平的
scout	skaut	n.侦察员，侦察机
chess	tʃes	n.棋；国际象棋
grade	greid	vt.给…分等级n.等级
opera	ɔpərə	n.歌剧
enable	i'neibl	vt.使能够，使可能
sword	sɔ:d	n.剑，刀
vary	veəri	vt.改变；使多样化
crisis	kraisis	n.危机；存亡之际
owner	əunə	n.物主，所有人
hollow	hɔləu	a.空的；空洞的
faulty	fɔ:lti	a.有错误的，有缺点的
party	pa:ti	n.党，党派；聚会
tank	tæŋk	n.坦克；大容器，槽
wing	wiŋ	n.翼，翅膀，翅
hungry	hΛŋgri	a.饥饿的；渴望的
essay	esei	n.短文，散文，小品文
basin	beisn	n.盆，洗脸盆；盆地
ignore	ig'nɔ:	vt.不顾，不理，忽视
wound	wu:nd	n.创伤，伤vt.使受伤
rival	raivəl	n.竞争者a.竞争的
worst	wə:st	a.最坏的ad.最坏地
exert	ig'zə:t	vt.尽(力)，运用
access	ækses	n.接近；通道，入口
spin	spin	vt.纺；使旋转n.旋转
graph	græf	n.(曲线)图，图表
spill	spil	vt.使溢出vi.溢出
swear	sweə	vt.宣(誓)vi.诅咒
flock	flɔk	n.羊群，群；大量
drawer	'drɔ:ə	n.抽屉
hammer	hæmə	n.锤，榔头vt.锤击
event	i'vent	n.事件，大事；事变
extend	iks'tend	vt.延长；扩大；致
hatred	heitrid	n.憎恶，憎恨，仇恨
wrist	rist	n.腕，腕关节
ensure	in'ʃuə	vt.保证；保护；赋予
issue	iʃu:	n.问题；发行vt.发行
filter	filtə	vt.过滤n.滤纸
follow	fɔləu	vt.跟随；结果是
trail	treil	n.痕迹；小径vt.跟踪
defend	di'fend	vt.&vi.防护辩护防卫保卫防守
wave	weiv	n.波；波涛vi.波动
ought	ɔ:t	v.aux.应当，应该
music	mju:zik	n.音乐，乐曲，乐谱
quick	kwik	a.快的；敏捷的
prove	pru:v	vt.证明vi.结果是
queue	kju:	n.行列vi.排队等候
basket	ba:skit	n.篮，篓，筐
eager	i:gə	a.渴望的，热切的
rainy	reini	a.下雨的，多雨的
butter	bΛtə	n.黄油；奶油
naval	neivəl	n.海军的，军舰的
react	ri'ækt	vi.起反应；有影响
maths	mæθs	n.(英)数学
affair	ə'feə	n.事情，事件；事务
horror	hɔrə	n.恐怖；战栗；憎恶
dialog	'daiəlɔg	n.对话对白(美)=dialogue
earth	ə:θ	n.地球；陆地，地面
ripe	raip	a.熟的；时机成熟的
tour	tuə	n.&vi.旅行，游历
civil	sivl	a.公民的；文职的
family	fæmili	n.家，家庭；家族
breast	brest	n.乳房；胸脯，胸膛
might	mait	v.aux.可能，会，也许n.力量，威力，能力
March	ma:tʃ	n.三月
energy	enədʒi	n.活力；精力；能
risk	risk	n.风险，危险，冒险
bounce	bauns	vi.反跳，弹起；跳起
press	pres	vt.压，按，揿；催促
unite	ju'nait	vi.联合vt.使联合
power	pauə	n.能力；力；权；幂
wheel	wi:l	n.轮，车轮
twin	twin	a.孪生的n.孪生儿
china	tʃainə	n.瓷器，瓷料
annoy	ə'nɔi	vt.使恼怒；打搅
reply	ri'plai	vi.&n.回答，答复
slit	slit	n.裂缝vt.切开，撕开
dying	'daiiŋ	adj.垂死的临终的n.死死亡
choose	tʃu:z	vt.选择，挑选；情愿
belong	bi'lɔŋ	vi.属于，附属
fatal	feitl	a.致命的；命运的
crown	kraun	n.王冠，冕；花冠
assign	ə'sain	vt.指派；分配；指定
suit	sju:t	n.起拆，诉讼【其动词形式为sue】vt.适合
grave	greiv	n.坟墓a.严重的
arise	ə'raiz	vi.出现；由…引起
empire	empaiə	n.帝国
cancer	kænsə	n.癌，癌症，肿瘤
boast	bəust	vi.自夸vt.吹嘘
bitter	bitə	a.痛苦的；严寒的
infer	in'fə:	vt.推论，推断；猜想
broad	brɔ:d	a.宽的，阔的；广泛的
wire	waiə	n.金属线；电缆；电信
crust	krΛst	n.面包皮；硬外皮
range	reindʒ	n.排，行；山脉；范围
doubt	daut	n.怀疑疑虑不信任vt.怀疑不信任vi.不确定
casual	kæʒjuəl	a.偶然的；随便的
wage	weidʒ	vt.开展(运动)
eagle	i:gl	n.鹰
toast	təust	n.烤面包vt.烘，烤
guess	ges	vt.&vi.&n.猜测，推测
behave	bi'heiv	vi.表现，举止；运转
relax	ri'læks	vt.使松弛vi.松弛
curve	kə:v	n.曲线；弯vt.弄弯
weep	wi:p	vi.哭泣，流泪
board	bɔ:d	n.板vt.上(船、车等)
child	tʃaild	n.小孩，儿童；儿子
expand	iks'pænd	vt.扩大；使膨胀
stage	steidʒ	n.舞台；戏剧；阶段
doctor	'dɔktə	n.医生医师博士vt.医治篡改对...做手脚vi.用药
clock	klɔk	n.钟，仪表
assist	ə'sist	vt.援助，帮助；搀扶
brown	braun	n.褐色，棕色
endure	in'djuə	vt.忍受；容忍
grace	greis	n.优美，文雅；雅致
seek	si:k	vt.寻找，探索；试图
vice	vais	n.罪恶；恶习；缺点
litre	li:tə	n.公升
absorb	əb'sɔ:b	vt.吸收；使专心
span	spæn	n.跨距；一段时间
expose	iks'pəuz	vt.使暴露；揭露
brick	brik	n.砖，砖块；砖状物
force	fɔ:s	vt.强迫n.力，力量
critic	kritik	n.批评家，爱挑剔的人
avenue	ævinju:	n.林荫道，道路；大街
brief	bri:f	a.简短的；短暂的
harden	ha:dn	vt.使变硬vi.变硬
stain	stein	vt.沾污；给…着色
place	pleis	n.地方，地点；住所
store	stɔ:	n.贮藏；贮存品；商店
crowd	kraud	n.群；大众；一伙人
trace	treis	n.痕迹；丝毫vt.跟踪
treat	tri:t	vt.对待；处理n.款待
spare	speə	vt.节约a.多余的
glance	gla:ns	vi.看一下n.一瞥
tire	taiə	vi.疲劳，累；厌倦
amuse	ə'mju:z	vt.逗…乐；给…娱乐
sake	seik	n.缘故，理由
border	bɔ:də	n.边，边缘；边界
deepen	'di:pən	vt.加深使...加深使...强烈vi.深化加深变浓
site	sait	n.地点，地基；场所
tray	trei	n.(浅)盘，托盘，碟
movie	mu:vi	n.电影；电影院
cliff	klif	n.悬崖，峭壁
bound	baund	a.一定的；有义务的
upset	Λp'set	vt.弄翻，打翻，倾覆
basic	beisik	a.基本的，基础的
meter	mi:tə	n.计量器，计，表
pause	pɔ:z	n.&vi.中止，暂停
post	pəust	n.邮政，邮寄；邮件
decent	'di:snt	adj.正派的体面的有分寸的得体的相当好的
eighty	eiti	num.八十，八十个
taste	teist	n.味觉，品味
quit	kwit	vt.离开，退出；停止
amaze	ə'meiz	vt.使惊奇，使惊愕
grass	gra:s	n.草；牧草；草地
banana	bə'na:nə	n.香蕉；芭蕉属植物
rural	ruərəl	a.农村的，田园的
metre	mi:tə	n.米，公尺
sail	seil	n.帆；船vi.航行
often	ɔ:fn	ad.经常，常常
empty	empti	a.空的；空洞的
depth	depθ	n.深度深厚深处强度诚挚
loyal	lɔiəl	a.忠诚的，忠心的
rare	reə	a.稀薄的；稀有的
heavy	hevi	a.重的；大的；充满的
eight	eit	num.八，八个，第八
demand	di'mɑ:nd	vt.要求需要询问n.要求需求
novel	nɔvəl	n.小说a.新的
aspect	æspekt	n.方面；样子，外表
gramme	græm	n.克
basis	beisis	n.基础，根据
flower	flauə	n.花，花卉；开花
crime	kraim	n.罪，罪行；犯罪
soak	səuk	vt.浸，泡vi.浸泡
bundle	bΛndl	n.捆，包，束；包袱
peach	pi:tʃ	n.桃子，桃树
ridge	ridʒ	n.脊；岭，山脉；垄
entry	entri	n.入口处；登记；进入
means	mi:nz	n.方法，手段，工具
cause	kɔ:z	n.原因，理由；事业
merit	merit	n.长处，优点；功过
suck	sΛk	vt.吸，吮，啜；吸收
claim	kleim	vt.声称，主张；索取
noble	nəubl	a.贵族的；高尚的
jɔint	dʒɔint	n.接头，接缝；关节
bride	braid	n.新娘
castle	ka:sl	n.城堡；巨大建筑物
garage	gæra:ʒ	n.车库；加油站
ŋegro	ni:grəu	n.黑人
grain	grein	n.谷物，谷粒；颗粒
juice	dʒu:s	n.(水果等)汁，液
never	nevə	ad.永不，决不；不
niece	ni:s	n.侄女，外甥女
forge	fɔ:dʒ	n.熔炉,铁工厂vt.打制,锻造,伪造
spade	speid	n.铲，铁锹
major	meidʒə	a.较大的n.专业
chill	tʃil	vt.使变冷n.寒冷
loose	lu:s	a.松的；宽松的
finish	finiʃ	vt.完成，结束n.结束
curse	kə:s	n.诅咒，咒骂；天谴
tyre	taiə	n.轮胎，车胎
coffee	kɔfi	n.咖啡，咖啡茶
patch	pætʃ	n.补钉；碎片vt.补缀
behalf	bi'ha:f	n.利益，维护，支持
class	kla:s	n.班，班级；阶级
race	reis	n.比赛，竞赛，竞争；人种，种族，民族
build	bild	vt.建筑；建立；创立
favour	feivə	n.好感；赞同；恩惠
slam	slæm	vt.使劲关，砰地放下
glove	glΛv	n.手套
maybe	meibi:	ad.大概，或许；也许
assess	ə'ses	vt.对(财产等)估价
bucket	bΛkit	n.水桶；吊桶；铲斗
naked	neikid	a.裸体的；无遮敝的
punch	pΛntʃ	vt.冲出n.冲压机
guide	gaid	n.导游者vt.给…导游
goose	gu:s	n.鹅，雌鹅
split	split	vt.劈开vi.被劈开
alike	ə'laik	a.同样的，相同的
found	faund	vt.创立，创办；建立
herɔic	hi'rəuik	a.英雄的；英勇的
cinema	sinimə	n.电影院；电影，影片
cruel	kruəl	a.残忍的，残酷的
slice	slais	n.薄片，切片；部分
cheap	tʃi:p	a.廉价的；劣质的
except	ik'sept	prep.除…之外
roar	rɔ:	vi.吼叫；呼喊n.吼
catch	kætʃ	vt.捉住；赶上；领会
heaven	hevn	n.天堂；天，天空
future	fju:tʃə	n.将来，未来；前途
common	kɔmən	a.普通的；共同的
seize	si:z	vt.抓住，逮捕；夺取
price	prais	n.价格，价钱；代价
clear	kliə	a.清晰的vt.清除
tone	təun	n.音；腔调；声调
pray	prei	vt.&vi.请求；祈祷
export	eks'pɔ:t,'ekspɔ:t	vt.输出，出口；运走
nylon	nailən	n.尼龙，耐纶
zone	zəun	n.地区，区域，范围
roast	rəust	vt.&vi.烤，炙，烘
import	im'pɔ:t'impɔ:t	vt.&n.输入，进口
detect	di'tekt	vt.察觉发觉侦察发现探测信息vi.当侦探
frown	fraun	vi.皱眉，蹙额
await	ə'weit	vt.等候，期待
effect	i'fekt	n.结果；效果，效力
paper	peipə	n.纸；官方文件；文章
course	kɔ:s	n.课程；过程；一道菜
camera	kæmərə	n.照相机，摄影机
diary	'daiəri	n.日记日记簿
campus	kæmpəs	n.校园，学校场地
ghost	gəust	n.鬼，灵魂；鬼魂
coach	kəutʃ	n.长途公共汽车
vast	va:st	a.巨大的；大量的
Indian	indiən	a.印度的n.印度人
gross	grəus	a.总的；严重的
magic	mædʒik	n.魔法，巫术；戏法
brass	bra:s	n.黄铜；黄铜器
alter	ɔ:ltə	vt.改变，变更；改做
barber	ba:bə	n.理发师
death	deθ	n.死死亡灭亡死神
brave	breiv	a.勇敢的，华丽的
grant	gra:nt	n.授给物vt.授予
mercy	mə:si	n.仁慈，慈悲，恩惠
ninth	nainθ	num.第九；九分之一
union	ju:njən	n.联合；团结；协会
farmer	fa:mə	n.农民，农夫；农场主
dragon	'drægən	n.龙凶暴的人严厉的人
check	tʃek	vt.检查；制止n.检查
screw	skru:	n.螺旋，螺丝vt.拧紧
sort	sɔ:t	n.种类；类别vt.整理
shift	ʃift	vt.替换，转移n.转换
cargo	ka:gəu	n.船货，货物
height	hait	n.高，高度；高处
nɔisy	nɔizi	a.嘈杂的；喧闹的
friend	frend	n.朋友，友人
creep	kri:p	vi.爬行；缓慢地行进
coast	kəust	n.海岸，海滨(地区)
engage	in'geidʒ	vt.使从事于；聘用
defeat	di'fi:t	vt.战胜击败挫败n.败北失败
radar	reidə	n.雷达，无线电探测器
digest	dai'dʒest	vt.消化领会理解vi.消化n.文摘摘要
wind	waind	vt.绕，缠绕vi.卷曲
every	evri	a.每一的；每隔…的
heart	ha:t	n.心，内心；勇气
route	ru:t	n.路，路线，路程
pinch	pintʃ	vt.捏，拧，掐掉
bridge	bridʒ	n.桥，桥梁；桥牌
silk	silk	n.蚕丝，丝，丝织品
field	fi:ld	n.田野；田；运动场
hardly	ha:dli	ad.几乎不，简直不
cement	si'ment	n.水泥；胶泥vt.粘结
credit	kredit	n.信用贷款；信用
cloudy	klaudi	a.多云的；云一般的
danger	'deindʒə	n.危险危险事物
jewel	dʒu:əl	n.宝石；宝石饰物
could	kud,kəd	aux.v.(can的过去式)
twist	twist	vt.捻；拧vi.&n.扭弯
crash	kræʃ	vi.碰撞，坠落n.碰撞
carry	kæri	vt.携带；运载；传送
rent	rent	n.租金，租vi.出租
worth	wə:θ	a.值…的n.价值
kneel	ni:l	vi.跪，跪下，跪着
royal	rɔiəl	a.王的；皇家的
cream	kri:m	n.奶油，乳脂；奶油色
fellow	feləu	n.人，家伙；伙伴
fruit	fru:t	n.水果；果实；成果
plate	pleit	n.板，片，盘vt.电镀
vague	veig	a.模糊的，含糊的
logic	lɔdʒik	n.逻辑，推理；逻辑性
habit	hæbit	n.习惯；习性
month	mΛnθ	n.月，月份
stake	steik	n.桩；赌金；奖品
pour	pɔ:	vt.灌，倒vi.倾泻
rank	ræŋk	n.排，横行；社会阶层
slide	slaid	vi.滑vt.使滑动n.滑
frame	freim	n.框架，框子；构架
forget	fə'get	vt.忘记，遗忘
stack	stæk	n.堆，垛vt.堆积
lucky	lΛki	a.幸运的；吉祥的
cloth	klɔ:θ	n.布；衣料；桌布
charge	tʃa:dʒ	vt.索价；控告n.费用
brake	breik	n.闸，刹车vi.制动
index	indeks	n.索引；指数；指标
dream	dri:m	n.梦梦想vt.&vi.做梦想象
Bible	baibl	n.基督教《圣经》
health	helθ	n.健康，健康状况
fulfil	ful'fil	vt.履行；满足；完成
orbit	ɔ:bit	n.运行轨道vt.环绕
least	li:st	a.最少的ad.最少
Greek	gri:k	a.希腊的n.希腊人
rust	rΛst	n.锈vi.生锈，氧化
stale	steil	n.陈腐的；走了气的
lever	li:və	n.杆，杠杆；控制杆
factor	fæktə	n.因素；因子，系数
float	fləut	vi.漂浮vt.使漂浮
guard	ga:d	vt.守卫；看守n.卫兵
beard	biəd	n.胡须，络腮胡子
handle	hændl	n.柄，把手vt.拿，触
solve	sɔlv	vt.解答，解释，解决
breath	breθ	n.气息，呼吸；气味
flood	flΛd	n.洪水vt.淹没
tune	tju:n	n.调子；和谐vt.调谐
adjust	ə'dʒΛst	vt.调整，调节；校正
humble	hΛmbl	a.谦逊的；地位低下的
prior	praiə	a.在先的；优先的
wreck	rek	n.失事；残骸vt.破坏
shot	ʃɔt	n.发射；弹丸；射门
human	hju:mən	a.人的，人类的n.人
trim	trim	a.整齐的vt.使整齐
glass	gla:s	n.玻璃；玻璃杯
rigid	ridʒid	a.刚硬的；僵硬的
govern	gΛvən	vt.统治，治理；支配
organ	ɔ:gən	n.器官；机构；管风琴
custom	kΛstəm	n.习惯，风俗；海关
eleven	i'levn	num.十一，十一个
former	fɔ:mə	a.在前的n.前者
march	ma:tʃ	vi.行军；游行示威
match	mætʃ	n.比赛，竞赛；对手
derive	di'raiv	vt.取得得自起源引申于vi.起源
fault	fɔ:lt	n.缺点；过失；故障
outer	autə	a.外部的，外面的
trunk	trΛŋk	n.树干；大衣箱，皮箱
gauge	geidʒ	vt.量，测量n.量器
carpet	ka:pit	n.地毯，毡毯，毛毯
chest	tʃest	n.胸腔，胸膛；箱子
rifle	raifl	n.步枪，来复枪
forbid	fə'bid	vt.禁止，不许；阻止
beach	bi:tʃ	n.海滩，湖滩，河滩
count	kaunt	vt.计算vi.数，计数
merry	meri	a.欢乐的，愉快的
liter	li:tə	n.公升
beside	bi'said	prep.在…旁边
horse	hɔ:s	n.马；马科动物
tame	teim	a.驯服的；顺从的
bullet	bulit	n.枪弹，子弹，弹丸
forth	fɔ:θ	ad.向前；向外，往外
either	aiðə,'i:ðə	pron.(两者)任何一个
silly	sili	a.傻的，愚蠢的
grocer	grəusə	n.食品商；杂货商
fabric	fæbrik	n.织物，纺织品；结构
laugh	la:f	vi.笑，发笑n.笑
define	di'fain	vt.给...下定义限定解释
want	wɔnt	n.需要；缺乏
panel	pænl	n.专门小组；面，板
skim	skim	vt.掠过，擦过；略读
famine	fæmin	n.饥荒；严重的缺乏
swell	swel	vi.膨胀；隆起；增长
yawn	jɔ:n	vi.打呵欠n.呵欠
troop	tru:p	n.军队；一群，大量
seed	si:d	n.种(子)，籽，萌芽
cheer	tʃiə	vt.使振作；欢呼
chase	tʃeis	n.追逐，追赶，追求
chart	tʃa:t	n.图，图表；海图
urban	ə:bən	a.都市的,住在都市的
focus	fəukəs	vi.聚焦，注视n.焦点
torch	tɔ:tʃ	n.火炬，火把；手电筒
fight	fait	vi.打(仗)；斗争
stiff	stif	a.硬的；僵直的
realm	relm	n.王国，国土；领域
ounce	auns	n.盎司，英两
excuse	iks'kju:z,iks'kju:s	vt.原谅；免除n.借口
proof	pru:f	n.证据；证明；校样
cough	kɔf	vi.咳，咳嗽n.咳嗽
fibre	faibə	n.纤维，纤维质
excess	ik'ses,'ekses	n.超越；过量；过度
engine	endʒin	n.发动机，引擎；机车
golden	gəuldən	a.金色的；极好的
pure	pjuə	a.纯粹的；纯洁的
wool	wul	n.羊毛；毛线，绒线
blame	bleim	vt.责备，把…归咎于
scan	skæn	vt.细看；浏览；扫描
button	bΛtn	n.扣子；按钮vt.扣紧
cheque	tʃek	n.支票
decide	di'said	vt.&vi.决定决心解决作出抉择
hobby	hɔbi	n.业余爱好，癖好
famous	feiməs	a.著名的，出名的
unit	ju:nit	n.单位；单元；部件
chalk	tʃɔ:k	n.白垩；粉笔
column	kɔləm	n.柱，支柱，圆柱
minus	mainəs	a.负的prep.减(去)
garden	ga:dn	n.花园，菜园；公园
rail	reil	n.横条，横杆；铁轨
pulse	pΛls	n.脉搏；脉冲，脉动
dress	dres	n.女服童装服装vt.&vi.穿著adj.正式的(衣服)
burst	bə:st	vt.使爆裂vi.&n.爆炸
tend	tend	vt.照管，照料，护理vi.走向，趋向；倾向
fetch	fetʃ	vt.拿来；请来，接去
track	træk	n.行踪；路径；轨道
learn	lə:n	vi.&vt.学，学习
commit	kə'mit	vt.犯(错误);干(坏事)
blast	bla:st	n.爆炸，冲击波vt.炸
attach	ə'tætʃ	vt.缚，系，贴；附加
cancel	kænsəl	vt.取消，撤消；删去
carbon	ka:bən	n.碳
globe	gləub	n.地球，世界；地界仪
utter	Λtə	a.完全的，彻底的vt.发出，说，讲
drink	driŋk	vt.&vi.饮喝喝酒n.饮料
blend	blend	vt.&vi.&n.混和
greet	gri:t	vt.问候，招呼；反应
cabin	kæbin	n.小屋；船舱，机舱
truth	tru:θ	n.真理；真实；真实性
wrap	ræp	vt.裹，包，捆n.披肩
forest	fɔrist	n.森林；森林地带
cease	si:s	vi.&vi.&n.停止，停息
crude	kru:d	a.简陋的；天然的
brand	brænd	n.商品；烙印vt.铭刻
spray	sprei	n.浪花；喷雾vt.喷
behind	bi'haind	prep.在…后面
radio	reidiəu	n.无线电；收音机
haste	heist	n.急速，急忙；草率
extra	ekstrə	a.额外的ad.特别地
candle	kændl	n.蜡烛；烛形物；烛光
money	mΛni	n.货币；金钱，财富
onion	Λnjən	n.洋葱，洋葱头
funny	fΛni	a.古怪的；滑稽的
figure	figə	n.数字；外形；人物
weave	wi:v	vt.织，编vi.纺织
refer	ri'fə:	vt.使求助于vi.谈到
queen	kwi:n	n.王后；女王
China	tʃainə	n.中国
barrel	bærəl	n.桶；圆筒；枪管
mayor	meə	n.市长
emerge	i'mə:dʒ	vi.出现，涌现；冒出
thus	ðΛs	ad.如此，这样；因而
beauty	bju:ti	n.美，美丽；美人
cheat	tʃi:t	vt.骗取；哄vi.行骗
bread	bred	n.面包；食物，粮食
convey	kən'vei	vt.传送；运送；传播
chief	tʃi:f	a.主要的；首席的
yield	ji:ld	vt.&vi.出产n.产量
trial	traiəl	n.试，试验；审判
cloud	klaud	n.云；云状物；阴影
crawl	krɔ:l	vi.爬，爬行
trick	trik	n.诡计；窍门vt.哄骗
dozen	'dʌzn	n.一打十二个adj.一打的十二个的
spite	spait	n.恶意,怨恨,不顾vt.刁难,欺侮
nɔise	nɔiz	n.喧闹声；响声；噪声
father	fa:ðə	n.父亲；神父；创始人
rain	rein	n.雨，雨水vi.下雨
wheat	wi:t	n.小麦
freeze	fri:z	vi.冻；结冻vt.使结冰
first	fə:st	num.第一ad.最初
borrow	bɔrəu	vt.借，借用，借人
aware	ə'weə	a.知道的，意识到的
greedy	gri:di	a.贪吃的；贪婪的
arouse	ə'rauz	vt.引起，唤起；唤醒
point	pɔint	n.点；要点；细目；分
cotton	kɔtn	n.棉；棉线；棉布
weed	wi:d	n.杂草，野草vi.除草
climb	klaim	vi.攀登，爬vt.爬
exact	ig'zækt	a.确切的；精确的
bubble	bΛbl	n.泡vi.冒泡，沸腾
knock	nɔk	vi.&vt.&n.敲，击，打
ending	endiŋ	n.结尾，结局；死亡
touch	tΛtʃ	vt.触摸；触动；感动n.触
shoot	ʃu:t	vt.发射；射中n.发芽
honey	hΛni	n.蜜，蜂蜜；甜，甜蜜
fierce	fiəs	a.凶猛的，狂热的
eighth	eitθ	num.第八n.八分之一
front	frΛnt	a.前面的n.前部
mouth	mauθ	n.嘴，口，口腔
flame	fleim	n.火焰；光辉；热情
battle	bætl	n.战役；斗争vi.作战
early	ə:li	ad.早a.早的，早期的
growth	grəuθ	n.增长；增长量；生长
attain	tein	vt.达到，获得，完成
paste	peist	n.糊，酱；浆湖
divide	di'vaid	vt.分分配分开(组)vi.除分开
stock	stɔk	n.原料；库存品；股本
robot	rəubɔt	n.机器人；自动机
indeed	in'di:d	ad.真正地；确实
FALSE	fɔ:ls	a.不真实的；伪造的
crush	krΛʃ	vt.压碎，碾碎；镇压
imply	im'plai	vt.暗示，意指
width	widθ	n.宽阔，广阔；宽度
editor	editə	n.编辑，编者，校订者
north	nɔ:θ	n.北，北方a.北方的
humour	hju:mə	n.幽默，诙谐，幽默感
canal	kə'næl	n.运河；沟渠；管
other	Λðə	a.另外的；其余的
affect	ə'fekt	vt.影响；感动
depart	di'pɑ:t	vi.离开起程出发死亡脱轨vt.离开
blade	bleid	n.刀刃，刀片；叶片
unity	ju:niti	n.单一；统一；团结
draft	dræft	n.草稿草图汇票徵兵vt.起草征兵选秀adj.酝酿中的
mouse	maus	n.鼠，耗子
devil	'devl	n.魔鬼恶魔坏人难对付的东西困难小尘暴vt.加料惹恼
seal	si:l	n.封蜡；印记vt.封
steer	stiə	vt.&vi.驾驶
clean	kli:n	a.清洁的；纯洁的
color	kΛlə	n.颜色，彩色；颜料
house	haus	n.房屋，住宅；商号
pupil	pju:pl	n.学生，小学生
marry	mæri	vt.娶，嫁vi.结婚
exist	ig'zist	vi.存在；生存，生活
differ	'difə	vi.不同(意见)相异不一致
laser	leizə	n.激光
evolve	i'vɔlv	vt.使进化；使发展
towel	tauəl	n.毛巾，手巾
vital	vaitl	a.生命的；有生命力的
usage	ju:zidʒ	n.使用，对待；惯用法
talk	tɔ:k	vi.讲话vt.谈论
knife	naif	n.小刀，刀，餐刀
zeal	zi:l	n.热心热情热忱
happen	hæpən	vi.发生；碰巧，恰好
German	dʒə:mən	a.德国的n.德国人
design	di'zain	vt.设计想像计划vi.计划设计n.设计图样
stoop	stu:p	vi.俯身；弯身n.弯腰
equal	i:kwəl	a.相等的；平等的
cable	keibl	n.缆，索；电缆；电报
below	bi'ləu	prep.在…下面(以下)
score	skɔ:	n.得分，比数，成绩
final	fainl	a.最后的；决定性的
fifty	fifti	num.五十，五十个
piano	pi'ænəu	n.钢琴
employ	im'plɔi	vi.雇用；用；使忙于
fancy	fænsi	n.想象力；设想；爱好
hello	hə'ləu	int.喂
burden	bə:dn	n.担子，重担；装载量
penny	peni	n.(英)便士；(美)分
driver	'draivə	n.驾驶员司机
sack	sæk	n.袋，麻袋；开除
weld	weld	vt.&n.焊接，熔接
plant	pla:nt	n.植物；工厂vt.栽种
stir	stə:	vt.动；拨动；激动
colony	kɔləni	n.殖民地；侨居地
church	tʃə:tʃ	n.教堂，礼拜堂；教会
dinner	'dinə	n.正餐主餐宴会晚宴
zebra	'zi:brə	n.斑马斑马线
fluid	flu(:)id	n.流体，液体
tube	tju:b	n.管；电子管，显像管
mount	maunt	vt.登上，爬上n.…山
bloom	blu:m	n.花；开花，开花期
ground	graund	n.地；场地；根据
mɔist	mɔist	a.湿润的；多雨的
prime	praim	a.首要的n.春，青春
reach	ri:tʃ	vt.抵达；伸出vi.达到
argue	a:gju:	vi.争论，争辩，辩论
proud	praud	a.骄傲的；自豪的
wear	weə	vt.磨损
annual	ænjuəl	a.每年的n.年报
frank	fræŋk	a.坦白的，直率的
shave	ʃeiv	vt.剃，刮vi.修面
ideal	ai'diəl	a.理想的；观念的
crane	krein	n.起重机，摄影升降机
tough	tΛf	a.坚韧的；健壮的
impose	im'pəuz	vt.把…强加；征(税)
enough	i'nΛf	a.足够的ad.足够地
belief	bi'li:f	n.信任，相信；信念
goods	gudz	n.货物，商品
pride	praid	n.骄傲；自豪vt.自夸
devise	di'vaiz	vt.设计发明遗赠n.遗赠(的财产)
handy	hændi	a.手边的；便于使用的
tower	tauə	n.塔vi.屹立，高耸
plane	plein	n.平面；飞机
ocean	əuʃən	n.海洋；洋
sour	sauə	a.酸的；脾气坏的
circle	sə:kl	n.圆，圆周；圈子
being	bi:iŋ	n.存在；生物；生命
close	kləuz,kləus	vt.关，闭；结束
deceit	di'si:t	n.欺骗欺诈诡计不诚实
stuff	stΛf	n.材料vt.装，填，塞
honest	ɔnist	a.诚实的；可敬的
craft	kra:ft	n.工艺；手艺，行业
cheek	tʃi:k	n.面颊，脸蛋
peace	pi:s	n.和平；和睦；平静
leave	li:v	vi.离去vt.离开
order	ɔ:də	n.次序；整齐vt.命令
extent	iks'tent	n.广度；范围；程度
cycle	saikl	n自行车，循环
grape	greip	n.葡萄；葡萄藤
forty	fɔ:ti	num.四十，第四十
quite	kwait	ad.完全；相当；的确
liver	livə	n.肝；肝脏
real	riəl	a.真的；现实的
tempt	tempt	vt.引诱，诱惑；吸引
corner	kɔ:nə	n.角；犄角；边远地区
scale	skeil	n.标度；比例；大小
bathe	beið	vt.给…洗澡；弄湿
hence	hens	ad.因此，所以；今后
motor	məutə	n.发动机；机动车
better	betə	a.较好的ad.更好地
tense	tens	n.时态，时a.拉紧的，绷紧的
group	gru:p	n.小组，群vi.聚集
type	taip	n.型，类型vi.打字
appeal	ə'pi:l	vi.&n.呼吁；申述
lorry	lɔri	n.运货汽车，卡车
pilot	pailət	n.领航员；飞行员
award	ə'wɔ:d	n.奖，奖品；判定
fence	fens	n.栅栏
grind	graind	vt.磨(碎)；磨快
rely	ri'lai	vi.依赖，依靠；信赖
frost	frɔst	n.冰冻，严寒；霜
rapid	ræpid	a.快的n.急流
become	bi'kΛm	vi.变成；成为，变得
serve	sə:v	vt.为…服务；招待
shore	ʃɔ:	n.滨，岸
print	print	vt.印刷n.印刷；正片
mould	məuld	n.模子，模型vt.浇铸
blank	blæŋk	a.空白的n.空白
begin	bi'gin	vi.开始vt.开始
fridge	fridʒ	n.电冰箱
camel	kæməl	n.骆驼
branch	bra:ntʃ	n.树枝；分部；分科
aboard	ə'bɔ:d	ad.在船(车)上；上船
fleet	fli:t	n.舰队；船队，机群
green	gri:n	a.绿色的n.绿色
tale	teil	n.故事，传说
breed	bri:d	n.品种vt.使繁殖
block	blɔk	n.街区vt.堵塞，拦阻
collar	kɔlə	n.衣领，项圈
value	vælju:	n.价值；价格vt.评价
phase	feiz	n.阶段；方面；相位
shed	ʃed	n.棚，小屋；贷棚vt.流出；散发；脱落
solar	səulə	a.太阳的，日光的
stair	steə	n.楼梯
night	nait	n.夜，夜间
decade	'dekeid	n.十年十年期
shear	ʃiə	vt.剪；剥夺vi.剪
rate	reit	n.比率；速度；价格
bleed	bli:d	vi.出血，流血；泌脂
volt	vəult	n.伏特，伏
lower	ləuə	a.较低的vt.放下
copper	kɔpə	n.铜；铜币，铜制器
equip	i'kwip	vt.装备，配备
alloy	ælɔi,ə'lɔi	n.合金；(金属的)成色
piece	pi:s	n.碎片，块vt.拼合
delay	di'lei	vt.推迟耽搁延误vi.耽搁n.耽搁迟滞
chain	tʃein	n.链，链条，项圈
crazy	kreizi	a.疯狂的，荒唐的
rush	rΛʃ	vi.冲，奔vt.催促
daring	'dɛəriŋ	adj.大胆的勇敢的n.冒险精神
flour	flauə	n.面粉，粉；粉状物质
trap	træp	n.陷阱；诡计vt.诱骗
layer	leiə	n.层，层次；铺设者
hazard	hæzəd	n.危险；公害
sign	sain	n.符号；招牌n.签名
slope	sləup	n.倾斜；斜面vi.倾斜
costly	kɔstli	a.昂贵的；价值高的
fresh	freʃ	a.新的；新鲜的
admit	əd'mit	vt.承认；准许…进入
alarm	ə'la:m	n.惊恐，忧虑；警报
damage	'dæmidʒ	vt.损害毁坏n.(pl.)赔偿损坏毁坏损害
excite	ik'sait	vt.使激动；引起
gather	gæðə	vi.聚集；集合vt.收集
choke	tʃəuk	vt.使窒息；塞满
county	kaunti	n.英国的郡，美国的县
genius	dʒi:njəs	n.天才，天赋，天资
sting	stiŋ	vt.刺；刺痛vi.&n.刺
beyond	bi'jɔnd	prep.在…的那边
shade	ʃeid	n.荫；遮光物vi.荫蔽
rouse	rauz	vt.唤醒，唤起；惊起
raise	reiz	vt.举起；引起；提高
breeze	bri:z	n.微风，和风
great	greit	a.大的；伟大的
bureau	bjuərəu	n.局，司，处；社，所
pull	pul	vt.拉，拖；拉，拉力
faint	feint	a.微弱的；虚弱的
afford	ə'fɔr:d	vt.担负得起…；提供
sole	səul	a.单独的，唯一的n.脚底，鞋底，袜底
dollar	'dɔlə	n.美元(货币单位)
decay	di'kei	vi.腐烂衰败n.腐烂衰退
career	kə'riə	n.生涯，职业，经历
sway	swei	vi.摇动vt.摇；摇动
trade	treid	n.贸易；职业vi.交易
highly	haili	ad.高度地，很，非常
yard	ja:d	n.院子，庭院；场地
hunger	hΛŋgə	n.饿，饥饿；渴望
guest	gest	n.客人，宾客；旅客
sweep	swi:p	vt.扫；刮起；扫过
gentle	dʒentl	a.和蔼的；轻柔的
phone	fəun	n.电话，电话机；耳机
income	inkΛm	n.收入；收益；进款
flesh	fleʃ	n.肉，肌肉；肉体
guilty	gilti	a.内疚的；有罪的
fever	fi:və	n.发热，发烧；狂热
water	wɔ:tə	n.水vt.使湿，灌溉
degree	di'gri:	n.程度度度数学位
later	leitə	ad.后来；过一会儿
vain	vein	a.徒劳的；自负的
bottom	bɔtəm	n.底，底部，根基
label	leibl	n.标签；标记，符号
badly	bædli	ad.坏，差；严重地
centre	sentə	n.中心；中枢vt.集中
fifth	fifθ	num.第五n.五分之一
large	la:dʒ	a.大的；巨大的
offer	ɔfə	vt.提供；提出n.提供
soil	sɔil	vt.弄脏vi.变脏
cross	krɔs	vt.穿过；使交叉
harsh	ha:ʃ	a.严厉的；刺耳的
shelf	ʃelf	n.搁板，架子
debate	di'beit	n.&vi.争论辩论商讨vt.争论思考
renew	ri'nju:	vt.使更新vi.更新
paint	peint	vt.画；油漆vi.绘画
pump	pΛmp	n.泵vt.用抽机抽
moral	mɔrəl	a.道德的；合乎道德的
expect	iks'pekt	vt.预料，预期；等待
steam	sti:m	n.蒸汽vi.蒸发vt.蒸
solid	sɔlid	a.固体的n.固体
devote	di'vəut	vt.将...奉献致力于投入于献身
cubic	kju:bik	a.立方形的；立方的
defect	di'fekt	n.缺点缺陷欠缺vi.背叛
waken	weikən	vi.醒来vt.弄醒
upper	Λpə	a.上面的；地位较高的
drown	draun	vi.淹死溺死vt.淹死沉浸于
widen	waidn	vt.加宽vi.变宽
total	təutl	a.总的vi.合计，总共
bottle	bɔtl	n.瓶，酒瓶；一瓶
flight	flait	n.航班；飞行；逃跑
clever	klevə	a.聪明的；机敏的
roll	rəul	vi.&vt.滚动；转动
dairy	'dɛəri	n.牛奶场乳制品乳品店adj.牛奶的
quiet	kwaiət	a.寂静的；安静的
black	blæk	a.黑色的；黑暗的
swing	swiŋ	vi.摇摆；回转n.摇摆
spark	spa:k	n.火花，火星